# Menu
User = Người dùng
Join... = Tham gia...
Login... = Đăng nhập...
Log in = Đăng nhập
Logout = Đăng xuất
Change password... = Đổi mật khẩu...
User Preference = Thiết lập người dùng
System Settings... = Thiết lập Hệ thống...
System Settings = Thiết lập Hệ thống
Crash = Bị hỏng...
Invite friends... = Mời bạn bè...
Language = Ngôn ngữ
Language Setting = Cài đặt ngôn ngữ

Document Recovery = Phục hồi tài liệu
Your Preferences Information = Thông tin tài khoản của bạn
File = Tập tin
New = Mới
Project... = Dự án...
Schematic = Sơ đồ
Schematic-Simulation = Mô phỏng mạch điện
Spice Symbol = Ký hiệu linh kiện
Spice Subckt = Linh kiện con
spicePre = Tiền tố linh kiện
PCB = PCB
Schematic Module = Mô đun Schematic
PCB Module = Mô đun PCB
Save... = Lưu lại...
Save As... = Lưu thành...
Save As Module... = Lưu dưới dạng Module...
Print = In ra
Export Document = Xuất tài liệu
LTspice... = LTspice...
Eagle... = Phần mềm Eagle...
Altium... = Phần mềm Altium...
Cadence... = Phần mềm Cadence...
Pads... = Khối mạch...
DXF = DXF
Import = Nhập tài liệu

Edit = Chỉnh sửa
Undo = Hoàn tác
Redo = Làm lại
Cut = Cắt tỉa
Copy = Sao chép
Paste = Dán
Select = Lựa chọn
Delete = Xóa bỏ
Clear All = Bỏ chọn tất
Move = Di chuyển
Drag = Kéo
Bring to Front = Di chuyển lên trước
Send to Back = Di chuyển xuống dưới cùng
Align = Căn chỉnh
Align Left = Căn trái
Align Right = Căn phải
Align Top = Căn theo đỉnh
Align Bottom = Căn xuống theo đáy
Align Horizontal Centers = Căn giữa theo chiều ngang
Align Vertical Centers = Căn giữa theo chiều dọc
Distribute Horizontally = Canh đều theo chiều ngang
Distribute Vertically = Canh đều theo chiều dọc
Distribute Left Edges Equidistantly = Canh đều theo lề trái
Distribute Top Edges Equidistantly = Canh đều theo lề phải
Align Grid = Căn theo lưới thiết kế
Rotate = Quay
Rotate Left = Quay trái
Rotate Right = Quay phải
Flip Horizontal = Lật ngang
Flip Vertical = Lật dọc
Rotate and Flip = Xoay và Lật
Group/Ungroup Symbol... = Gộp/Bỏ gộp linh kiện

[menu_project]
View = Lượt xem
[/menu_project]
Find = Tìm
Zoom In = Phóng to
Zoom Out = Thu nhỏ
Fit in Window = Vừa trong cửa sổ
Refresh = Làm tươi
Snap = Tự động dính vào
Cross Cursor = Con trỏ
Toolbars = Thanh công cụ
Drawing Tools = Công cụ vẽ
Wiring Tools = Công cụ nối mạch
Power Objects = Các thành phần cấp nguồn
PCB Tools = Công cụ PCB
Footprint Tools = Công cụ thiết kế linh kiện mẫu
Layers Tool = Công cụ điều chỉnh lớp mạch
Layer Manager = Trình quản lý lớp mạch
Enable and Show All Layers = Kích hoạt, hiển thị tất cả các lớp mạch
Net Visible = Mạch đang hiển thị
Auto = Tự động
Digital Objects = Thành phần số
Tools = Công cụ
Arc Center = Cung tròn định tâm
Arc Type = Kiểu cung tròn
Center Point Arc = Tâm cung tronf
Two-point Arc = Cung tròn 2 điểm

Place = Nơi
Drawing Tools = Công cụ vẽ
Arc = Vòng cung
Elliptical Arc = Cung elip
Ellipse = Elip
Circle = Đường tròn
Pie = Hình bánh
Line = Đường
Polyline = Đường nối nhiều đoạn
Rectangle = Hình chữ nhật
Rectangular = Hình chữ nhật
The rectangle does not support non-90 degree rotation. Please use Solid Region instead. = Hình chữ nhật không hỗ trợ quay góc khác 90 độ. Hãy thay bằng vùng đồng nhất.

Rect = Chữ nhật
Round Rectangle = Hình chữ nhật bo góc
Polygon = Đa giác
Bezier = Đường cong Bezier
Path = Đường nối
Graphic = Đồ họa
Bus = Đường mạch chính
Bus Entry = Đầu vào đường mạch chính
Junction = Mối nối
Net Port = Điểm nối
Voltage Probe = Điểm đo điện áp
Power Port = Điểm cấp nguồn
Wire = Dây điện
Annotation = Chú thích
Track = Đường mạch
Image = Hình ảnh
Arrow Head = Đầu mũi tên
Arrowhead = Mũi tên
Arrow = Mũi tên
No Connect Flag = Không kết nối
Place = Khu vực
Pin = Ghim
Lock Selected Objects = Khóa các đối tượng đã chọn

Miscellaneous = Khác
Find Component = Tìm linh kiện
Component = Linh kiện
Footprint... = Mẫu linh kiện...
This component is deleted! = Linh kiện này đã bị xóa
Convert = Chuyển đổi
Convert Schematic to PCB = Chuyển Sơ đồ sang mạch điện
The component ID will be reset according to the component prefix, this operation will clear Undo histories. Please notice: = Mã linh kiện đã được khôi phục theo tiền tố linh kiện, hành động này sẽ xóa lịch sử hoàn tác. Hãy lưu ý:
Please make sure the component prefixes of the schematic and PCB are corresponding = Cần chắc chắn là tiền tố  của sơ đồ mạch và mạch in PCB là khơp với nhau
Please reset the component ID of corresponding schematic or corresponding PCB too = Hãy thiết lập lại Mã linh kiện của Sơ đồ mạch cũng như bản mạch PCB tương ứng
Do you want to continue? = Bạn muốn tiếp tục không?
Reset Component ID = Thiết lập lại mã linh kiện
Component ID reset successfully! = Mã linh kiện đã được thiết lập lại thành công
Convert to PCB = Chuyển đổi sang mạch in PCB
Update PCB = Cập nhật mạch in PCB
Shortcut Keys Setting = Cài đặt phím tắt
Edit Symbol... = Chỉnh sửa ký hiệu linh kiện...
Highlight Net... = Đánh dấu đường mạch...
Simulate = Mô phỏng
Simulation = Mô phỏng
Standard Mode = Chế độ tiêu chuẩn
Simulation Mode = Chế độ mô phỏng
Change to Standard Mode = Đổi sang chế độ Tiêu chuẩn
Change to Simulation Mode = Đổi sang chế độ Mô phỏng
Welcome to Use LCEDA = Chào mừng bạn Sử dụng LCEDA
Welcome to Use EasyEDA = Chào mừng bạn sử dụng EasyEDA
Enable Education Edition Features for Free >>> = Kích hoạt miễn phí các tính năng của phiên bản Giáo dục
Quick Start = Bắt đầu ngay
More Help = Trợ giúp thêm
Explore = Khám phá
Message = Thông điệp
[start]
Example = Ví dụ
Forum = Diễn đàn
Tutorials = Hướng dẫn
Videos = Tài liệu dạng Video
[/start]
Custom Data = Dữ liệu tùy biến
LCEDA = LCEDA

Copy Result Image = Chép ảnh sản phẩm
Export Result Image = Xuất ảnh sản phẩm
Simulation Result = Kết quả Mô phỏng
Simulation Results... = Kết quả Mô phỏng...
Simulate this Sheet = Mô phỏng bản vẽ này
Simulate this Project = Mô phỏng Dự án này
Non-simulation mode, please switch to the simulation mode first and then run = Đang ở chế độ không mô phỏng, hãy chuyển sang chế độ Mô phỏng sau đó thực hiện
Run the Document = Thực hiện Mô phỏng bản vẽ
Run the Project... = Thực hiện Mô phỏng dự án...
Netlist for Document = Danh sách các đường mạch của bản vẽ
Netlist for Project = Danh sách các đường mạch của Dự án
LTspice for This Sheet... = LTspice của bản vẽ
Spice for this Project... = Ký hiệu của Dự án
Protel/Altium for PCB... = Phiên bản Protel / Altium cho mạch in PCB...
PADS for PCB... = Phiên bản PADS cho mạch in PCB
FreePCB for PCB... = Phiên bản FreePCB cho mạch in PCB...
Eagle for PCB... = Phiên bản Eagle cho mạch in PCB...
Kicad for PCB... = Phiên bản Kicad cho mạch in PCB...
OrCAD for PCB... = Phiên bản OrCAD cho mạch in PCB...
BOM report... = Báo cáo danh sách linh kiện...
BOM for Document... = Danh sách linh kiện của Bản vẽ...
BOM for Project... = Danh sách linh kiện của dự án...
Pin Manager... = Trình quản lý Chân linh kiện
Spice Model... = Mô hình linh kiện
Layer Manager... = Trình quản lý lớp mạch
Net Color... = Màu đường mạch
Design Rule... = Nguyên tắc thiết kế
Copper Area = Vùng phủ đồng
Rebuild Selected = Định hình lại vùng đang chọn
Rebuild All = Định hình lại tất cả
Copper Area Manager... = Trình quản lý Vùng phủ đồng
Export Pick and Place File = Xuất tệp Tọa độ
Measure Distance = Đo khoảng cách
Set Canvas Origin by Mouse Location = Đặt gốc bản vẽ vào điểm con trỏ chuột
Generates Pick and Place File = Tạo tệp tọa độ linh kiện
Unroute All = Xoá tất cả đường mạch
Auto Route = Tự động đi mạch
Export Autorouter File(DSN) = Xuất tập tin Đi mạch tự động (DSN)
Import Autorouter Session File(SES) = Nhập phiên Đi mạch tự động
Autorouter File(DSN) = Tập tin Đi mạch tự động (DSN)
Autorouter Session File(SES) = Phiên Đi mạch tự động (SES)
Terminate Routing Automatically = Dừng đi mạch tự động
Delete Segments = Xóa bỏ đoạn mạch
Unroute Connections = Bỏ đoạn nối  mạch đã vẽ
Unroute Connection = Bỏ đoạn nối mạch đã vẽ
Unroute Nets = Bỏ đường mạch
Select = Chọn
Segments = Đoạn mạch
Connection = Đoạn nối mạch
Net = Đường mạch
Apply Design Rule While Routing and Auto Placing Via = Thực hiện nguyên tắc thiết kế trong khi đi mạch và tự động định vị đường mạch thông qua

Add SubPart = Thêm SubPart
Annotate... = Chú thích...
Config = Cấu hình

Help = Trợ giúp
About = Giới thiệu về phần mềm
Shortcut Keys = Phím tắt
FAQ = Câu hỏi thường gặp
Tutorials = Hướng dẫn
Basic Tutorials = Hướng dẫn cơ bản
Video Tutorials = Video hướng dẫn
Essential Check = Kiểm tra cơ bản
Simulation Tutorials = Hướng dẫn Mô phỏng
Updated Instructions = Hướng dẫn cập nhật
Open File Format = Định dạng tập tin
About Upgrade = Giới thiệu về Nâng cấp
User Forum = Diễn đàn người dùng
Feature Request = Yêu cầu tính năng
Feature Requests = Yêu cầu tính năng
Bug Report = Báo cáo lỗi
Bug Reports = Báo cáo lỗi
Tips & Skill = Mẹo & Kỹ năng
Ask for Help = Yêu cầu trợ giúp
Schematic Capture = Dựng bản vẽ từ hình ảnh
Spice Simulation = Mô phỏng linh kiện
Non-simulation mode = Chế độ không mô phỏng
PCB Layout = Hình dạng PCB
General Discussion = Thảo luận chung
More Information = Thông tin thêm
Privacy Policy = Chính sách bảo mật
#Terms of Use & Privacy Policy
Terms of Service = Điều khoản Dịch vụ
Plans and Pricing = Gói dịch vụ và Giá cả
Help Translate = Giúp Dịch thuật
About Us = Về chúng tôi
Contact Us = Liên hệ chúng tôi
Change History = Lịch sử thay đổi
Join Us = Tham gia với chúng tôi
#PCB Fabrication Capabilities
PCB Fabrication = Chế tạo PCB
Order Capabilities = Khả năng Đặt hàng
Order Price = Giá đặt hàng
Order Essential Check = Đặt hàng dịch vụ Kiểm tra
Order FAQ = Đặt hàng câu hỏi thường gặp
Order Process = Quá trình đặt hàng
Full Screen = Toàn màn hình

Support = Ủng hộ
[leftNavTabs]
Support = Ủng hộ
[/leftNavTabs]
Historical Records... = Dữ liệu lịch sử...
Extensions = Công cụ mở rộng
Order PCB... = Đặt hàng PCB...
Import Changes = Nhập Thay đổi
Press {0}F11{1} to switch to full screen. = Nhấn {0}F11{1} để chuyển sang toàn màn hình.
Delete Selected = Xóa đối tượng đã chọn
Simulate... = Mô phỏng...
Config = Cấu hình
Terms of Service & Privacy Policy = Về chính sách bảo mật dịch vụ
Help Topics = Chủ đề trợ giúp
3D Model(obj) = Mô hình 3D (obj) 
3D Model(step) = Mô hình 3D (step) 
SVG Source... = Tập tin SVG nguồn...
File Source = Tập tin nguồn
Group These Items as a Symbol = Nóm các đối tượng này theo Ký hiệu linh kiện
Group These Items as a Footprint = Nóm các đối tượng này theo Mẫu linh kiện
Set Canvas Origin = Thiết lập nền vẽ gố
Document Setting = Thiết lập tài liệu
Sheet Attributes = Thuộc tính bản vẽ
Set Board Outline = Thiết lập khung bản mạch
Teardrop... = Teardrop...
Panelize... = Dựng panel bản mạch PCB
Check Dimension = Kiểm tra kích thước
Smart Dimension = Định kích thước thông minh
Footprint Wizard = Quy trình tạo Mẫu linh kiện
Footprint Wizard... = Quy trình tạo Mẫu linh kiện...
Select package type = Chọn loại linh kiện
Smart Dimension Attributes = Định đặc tính kích thước thông minh
Global Delete = Xóa toàn bộ
Cross Probe = Đo tín hiệu ngang
Cross Probe and Place = Đo tín hiệu ngang và định vị
Paper Size = Cỡ giấy
Register = Đăng ký
User Center = Trung tâm Người dùng

By Mouse Location = Theo vị trí trỏ chuột
Set Coordinate = Thiết lập tọa độ
By Coordinates... = Theo tọa độ
By Center of Pads = Theo trọng tâm của Miếng mạch
By Center Grid of Symbols = Theo trọng tâm lưới linh kiện

#Schematic Canvas Attributes
Properties = Tính chất
Attributes = Thuộc tính
Apply = Áp dụng
Save as default = Lưu làm mặc định
Canvas Attributes = Thuộc tính nền vẽ
Width = Chiều rộng
Height = Chiều cao
Background = Nền
Visible Grid = Lưới hiển thị
Grid Visible = Lưới nhìn thấy được
Real-Time Track Length = Đo độ dài đường mạch trực tiếp
Display Real-Time Track Length = Hiển thị đường mạch trực tiếp
Grid Color = Màu lưới
Grid Size = Kích thước lưới
Grid Style = Kiểu lưới
Grid.Line Width = Độ rộng đường lưới
Grid.Line Spacing = Khoảng cách đường lưới
Copper to Board Outline = Chuyển đổi vùng phủ đồng sang Mạch PCB
Improve Fabrication = Cải thiện chế tạo bản mạch
Spoke Width = Độ lớn đường nối
Stroke Color = Màu đường kẻ
Stroke Width = Chiều rộng dòng
Stroke Style = Kiểu đường
Fill Color = Tô màu
Selected Objects = Đối tượng được chọn
Frame Size = Kích thước tổng thể
Alt Snap = Alt Snap
Snap size when pressing the Alt key = Kích thước snap khi nhấn phím Alt
Prefix Start = Bắt đầu của tiền tố

#Text Attributes
Text Attributes = Thuộc tính chữ
Text = Chữ
Color = Màu
Font Family = Kiểu phông chữ
Font Size = Cỡ chữ
Font Weight = Độ đậm Phông chữ
Font Style = Kiểu Phông chữ
Text Type = Dạng chữ
Text Anchor = Điểm neo Chữ
Baseline = Đường cơ sở
(Auto) = (Tự động)
(auto) = (Tự động)
start = bắt đầu
middle = giữa
end = cuối
inherit = thừa kế
comment = Nhận xét
spice = Mô phỏng Spice
normal = bình thường
italic = chữ nghiêng
Default = Mặc định
Add = Thêm
bold = đậm
bolder = đậm hơn
lighter = mảnh hơn
Failed to parse the font file: {name} = Không thể tải tệp phông chữ: {name}
Please select a font file of ttf or woff format. = Vui lòng chọn tệp phông có định dạng ttf hoặc woff.
Add font success: {name} = Thêm phông {name} thành công:
Failed to add font: {name} = Không thể thêm phông: {name}
Add Font = Thêm Phông chữ
Failed to parse cached font: {name} = Không tải được phông {name} lưu trữ trong bộ nhớ cache
Load cached fonts fail! = Tải các phông đã lưu trong bộ nhớ cache không thành công!

#Stroke
Stroke Color = Màu đường kẻ
Stroke Width = Chiều rộng dòng
Stroke Style = Kiểu đường
Fill Color = Tô màu
X Radius = Bán kính góc X
Y Radius = Bán kính góc y

#spice
Switch mode = Chuyển chế độ
The current documents will be closed, and reopen after switching mode, do you want to continue? = Tài liệu hiện thời sẽ bị đóng, và mở ra sau khi chuyển chế độ, bạn có muốn tiếp tục không?
PCB related documents are not allowed in emulation mode = Tài liệu liên quan đến bản mạch PCB không dùng được trong chế độ Mô phỏng
Please change the editor to "Simulation" mode first at the top left corner. = Hãy đổi giao diện thiết kế sang "Chế độ Mô phỏng" ở góc trái trên cùng trước.
Please change the editor to "Standard" mode first at the top left corner. = Hãy đổi giao diện thiết kế sang "Chế độ Tiêu chuẩn" ở góc trái trên cùng trước.
Common = Thông dụng
spice.open = spice.open
spice.close = spice.close 
Sources = Nguồn
Instrument = Công cụ
Transistors = Bóng bán dẫn
Digital Circuits = Mạch số
Operational Amplifier = Mạch khuếch đại
multimeter = dụng cụ đo
multimeter Settings = thiết lập dụng cụ đo
FunctionGenerator Settings = Thiết lập Công cụ tạo chức năng
Voltage Source Settings = Thiết lập Nguồn điện áp
Current Source Settings = Thiết lập Dòng hiện thời
Powersw Settings = Thiết lập nguồn Powersw 
Resistor Settings = Thiết lập Điện trở
Capacitor Settings = Thiết lập Tụ điện
Diode Settings = Thiết lập Đi ốt
voltPowersw Settings = Thiết lập điện áp nguồn voltPowersw
Inductor Settings = Thiết lập Cuộn cảm
VCVS Settings = Thiết lập VCVS 
CCCS Settings =Thiết lập CCCS 
VCCS Settings = Thiết lập VCCS 
CCVS Settings = Thiết lập CCVS 
JFET Settings = Thiết lập JFET 
FET Settings = Thiết lập FET 
Transmission Line Settings = Thiết lập đường truyền tin hiệu
Oscilloscope Settings = Thiêt lập máy Ô si lô
XFMR Settings = Thiết lập XFMR 
LOGIC Settings = Thiết lập Lô gic (LOGIC)
LOGICSTATE Settings = Thiết lập Cổng Lô gic (LOGICSTATE)
DIGITALCLOCK Settings = Thiết lập Đồng hồ số (DIGITALCLOCK)
Potentiometer Settings = Thiết lập biến trở (Potentiometer)
MUTUAL_INDUCTORS Settings = Thiết lập MUTUAL_INDUCTORS 
NE555 Settings = Thiết lập NE555 
THREE_PHASE Settings = Thiết lập THREE_PHASE 
Logic_Probe Settings = Thiết lập Logic_Probe 
78XX Settings = Thiết lập 78XX 
79XX Settings = Thiết lập 79XX 
OPAMP5PEE Settings = Thiết lập OPAMP5PEE 
OPAMP5PEECN Settings = Thiết lập OPAMP5PEECN 
OPAMP3PEE Settings = Thiết lập OPAMP3PEE 
OPAMP3PEECN Settings = Thiết lập OPAMP3PEECN 
DELAY_FUSE Settings = Thiết lập DELAY_FUSE
Ratio = Tỷ lệ
K[%]
Model = Loại
States = Trạng thái
Voltage[V]
Voltage gain[V/V]
Current gain[A/A]
Transconductance[Mho]
Transresistance[Ω]
Voltage Source Type = Kiểu nguồn điện áp
Current Source Type = Kiểu dòng hiện thời
multimeter type = loại máy đo
power type = loại nguồn
Voltmeter Resistance(R)(Ω) = Đo điện áp theo trỏ kháng (R)(Ω)
Amperometer Resistance(R)(Ω) = Đo dòng theo trở kháng (R)(Ω)
mu.V =mu.V
mu.A =mu.A 
Sine Wave = Sóng Sin
Triangular Wave = Sóng vuông
Rectangular Wave = Sóng chữ nhật
AC = Xoay chiều (AC)
DC = Một chiều (DC)
SINE = SIN
PULSE = XUNG
EXP = MŨ
SFFM =SFFM 
PWL =PWL 
B.spice =B.spice 
DC Value[V]
DC Value[A]
DC offset[V]
DC offset[A]
Amplitude[V]
Amplitude[A]
Freq[Hz]
Theta[1/s]
Tdelay[s]
Phi[deg]
Tperiod[s]
Ton[s]
Tfall[s]
Trise[s]
Von[V]
Von[A]
Vinitial[V]
Vinitial[A]
Vpulsed[V]
Vpulsed[A]
Rise Delay[s]
Rise Tau[s]
Fall Delay[s]
Fall Tau[s]
Carrier Freq[Hz]
Modulation Index = Chỉ số biên độ
Signal Freq[Hz]
Time[s]
Value[V]
Value[A]
Waveforms =
Duty cycle[%]
Amplitude[Vp]
Offset[V]
Rise/Fall Time[sec]
Capacitance[F]
sComponent =s Component 
Inductance[H]
Gbw = Gbw 
Slewrate = Chu kỳ quét
Avol =Avol 
Rout(Ω) =Rout(Ω) 
Rin(Ω) =Rin(Ω) 
Ibias[A]
Inhi[V]
Inlo[V]
Isc[A]
Outhi[V]
Outlo[V]
Vabsmax[V]
Vmin[V]
Iq[A]
Cin[F]
high = cao
low = thấp
Oscilloscope = Ô si lô
Logic Analyzer = Phân tích Lô gic
Channel_A = Kênh_A
Channel_B = Kênh_B
Channel A = Kênh A
Channel B = Kênh B
Time = Thời gian
Reverse = Đảo
Simulation file exceed = Tập tin Mô phỏng vượt quá
The simulation file is too large and has been stopped for performance reasons. = Tập tin mô phỏng quá lớn và đã bị dừng thực thi do năng lực mô phỏng của thiết bị
Timebase = Định thời
Scale: = Tỷ lệ:
X pos.(Div): =X pos.(Div): 
Y pos.(Div): =Y pos.(Div): 
View meter... = Xem công cụ đo
The circuit has components without simulation model: = Mạch điện có linh kiện không có chế độ mô phỏng
Your simulation interval is too short to simulate, please wait 5 seconds later and try again; if still show this message, may be you simulated over 500 times the maximum simulation times per day. = Định thời gian mô phỏng quá ngắn, hãy đợi thêm 5 giây và thử lại; nếu thông điệp này vẫn hiện ra, có lẽ bạn đã mô phỏng quá 500 lần trên ngày.
Resistor1_US = Điện trở kiểu Mỹ (1_US)
Resistor1_EU/IEC =Điện trở kiểu Châu Âu (1_EU/IEC )
Resistor1_3D =Điện trở kiểu 3D (1_3D) 
Capacitor1_US =Capacitor1_US 
Capacitor1_EU/IEC =Capacitor1_EU/IEC 
Capacitor1_3D =Capacitor1_3D 
Rheostat_US =Rheostat_US 
Rheostat_EU/IEC =Rheostat_EU/IEC 
Rheostat_3D =Rheostat_3D 
Capacitor_Electrolytic_US =Capacitor_Electrolytic_US 
Capacitor_Electrolytic_EU/IEC =Capacitor_Electrolytic_EU/IEC 
Capacitor_Electrolytic_3D =Capacitor_Electrolytic_3D 
Inductor_US =Inductor_US 
Inductor_EU/IEC =Inductor_EU/IEC 
Inductor_3D =Inductor_3D 
Resistor2_US =Resistor2_US 
Resistor2_EU/IEC =Resistor2_EU/IEC 
Resistor2_3D =Resistor2_3D 
Multimeter = Máy đo
Multimeter_3D = Máy đo _3D 
Oscilloscope = Máy hiện sóng
Oscilloscope_3D = Máy hiện sóng_3D
Signal_Generator = Bộ tạo tín hiệu
Signal Generator_3D = Bộ tạo tín hiệu _3D
Wattmeter = Máy đo Công suất
Wattmeter_3D = Máy đo Công suất_3D
NSSWS1080T_3D = NSSWS1080T_3D
Voltage_Source_VDC = Nguồn điện áp_VDC
Voltage_Source_VSin = Nguồn điện áp_VSin
Voltage_Source_VPULSE = Nguồn điện áp_VPULSE
Voltage_Source_VEXP = Nguồn điện áp_VEXP
Voltage_Source_VSFFM = Nguồn điện áp_VSFFM
Voltage_Source_VPWL = Nguồn điện áp_VPWL
Voltage_Source_V_Behavioral_Source = Nguồn điện áp_V_Đặc tính nguồn
Current_Source_IDC = Dòng hiện thời_IDC 
Current_Source_ISin = Dòng hiện thời_ISin
Current_Source_IPULSE = Dòng hiện thời_IPULSE
Current_Source_IEXP = Dòng hiện thời_IEXP
Current_Source_ISFFM = Dòng hiện thời_ISFFM
Current_Source_IPWL = Dòng hiện thời_IPWL
Current_Source_I_Behavioral_Source = Dòng hiện thời _I_Đặc tính dòng
CCCS_1 = CCCS_1
CCCS_2 = CCCS_2 
CCVS_1 = CCVS_1 
CCVS_2 = CCVS_2
VCCS = VCCS 
VCVS = VCVS 
Three_Phase_Wye_Load = Tải Wye ba pha
Three_Phase_Delta_Load = Tải Delta ba pha
78XX = 78XX
79XX = 79XX
555 = Chíp hẹn giờ 555
555_3D = Chíp 555_3D
Transformer_US = Biến áp (kiểu US)
Transformer_EU/IEC = Biến áp (kiểu EU/IEC)
Transformer_Center_Tapped_US = Biến áp tự ngẫu (kiểu US)
Transformer_Center_Tapped_EU/IEC = Biến áp tự ngẫu (kiểu EU/IEC)
Mutual_Inductor_US = Biến áp cảm ứng (kiểu US)
Mutual_Inductor_EU/IEC = Biến áp cảm ứng (kiểu EU/IEC)
Mutual_Inductor2_US = Biến áp cảm ứng 2 (kiểu US)
Mutual_Inductor2_EU/IEC = Biến áp cảm ứng 2 (EU/IEC)
OR2EE_US =
OR3EE_US =
OR4EE_US =
OR2EE_CN =
OR3EE_CN =
OR4EE_CN =
NOR2EE_US =
NOR3EE_US =
NOR4EE_US =
NOR2EE_CN =
NOR3EE_CN =
NOR4EE_CN =
AND2EE_US =
AND3EE_US =
AND4EE_US =
AND2EE_CN =
AND3EE_CN =
AND4EE_CN =
NAND2EE_US =
NAND3EE_US =
NAND4EE_US =
NAND2EE_CN =
NAND3EE_CN =
NAND4EE_CN =
XOR2EE_US =
XOR2EE_CN =
XNOR2EE_US =
XNOR2EE_CN =
Digital_Clock_1Hz = Đồng hồ số 1Hz
Logicstate_0 = Trạng thái lô gic_0
Logicstate_1 = Trạng thái lô gic_1
Logic_Probe = Dò lô gic
Buffee =
INVEE_US =
INVEE_CN =
Schmittbuffee =
LM358N_US =
LM358N_CN =
OPAMP3PEE_US =
OPAMP3PEE_CN =
OPAMP5PEE_US =
OPAMP5PEE_CN =
Voltage_Controlled_Switch = Công tắc điều khiển điện áp
Current_Controlled_Switch = Công tắc điều khiển dòng 
FUSE = CẦU CHÌ
Delay_Fuse = Cầu chì trễ
Transmission_Line = Đường truyền
Crystal = Thạch anh
DFFEE =
TFFEE =
JKFFEE =
SRFFEE =
SRLATCHEE =
SRNANDFFEE =
SRNORFFEE =
INVTSEE =
INVODEE =
Schmittbuffee =
Cbuffer =
SPDT_Open = SPDT_Mở
SPDT_Close = SPDT_Đóng
SPST_Close = SPST_Đóng
SPST_Open = SPST_Mở
Fast_Crystal = Thạch anh nhanh
Lamp = Đèn
BCD_Segment = Hiển thị BCD
Seven_Segment = Hiển thị Bảy đoạn
Traffic_Light = Đèn báo hiệu
Lamp Settings = Thiết lập đèn
Power[W] 
Dropout Voltage[V]
Current[A]
Threshold[V]
Clock Rate = Xung đồng hồ
TrafficLight Settings = Thiết lập Đèn báo hiệu
BCDSegment Settings = Thiết lập hiển thị BCD
SevenSegment Settings = Thiết lập hiển thị 7 đoạn
SPDT Settings = Thiết lập SPDT
SPST Settings = Thiết lập SPST
LogicAnalyzer Settings = Thiết lập phân tích Lô gic
Fuse Settings = Thiết lập cầu chì
Wattmeter Settings = Thiết lập đo Công suất
open = mở
close = đóng
Common Anode = Cực Dương chung
Common Cathode = Cực Âm chung
AC Amplitude = biên độ AC
AC Phase = Pha AC
There are some parts haven't spice model, please use "EElib" and "Spice Symbol" at "Libraries" of "Simulation" mode, or you can assign the spice model for them: = Có một số linh kiện không có mẫu ký hiệu, hãy dùng "EElib" và "Ký hiệu linh kiện" ở mục "Thư viện" trong chế độ "Mô phỏng", hoặc bạn cũng có thể gán mẫu linh kiện cho chúng:

#Pin
Pin Attributes = Thuộc tính chân linh kiện
Orientation = Hướng
Line 45° = Đường 45°
Line 90° = Đường 90°
Arc 45° = Cung 45°
Arc 90° = Cung 45°
Free Angle = Vẽ góc tùy ý
Start X = Điểm bắt đầu X
Start Y = Điểm bắt đầu Y
Length = Chiều dài
Name = Tên
name = tên
Number = Số
Spice Pin Order = Thứ tự chân linh kiện
Display Number = Số hiển thị
Clock = Đồng hồ
Show = Hiển thị Chân linh kiện
Electric = Đặc tính điện học

#Junction
Junction Attributes = Thuộc tính điểm nối
X Location = Vị trí X
Y Location = Vị trí Y
Size = Kích thước
Color = Màu

#Net Label
Net Label = Nhãn mạch

#Part
Prefix = Tiền tố

#Image Attributes and Dialog
Add Image = Thêm Ảnh
Image Attributes = Thuộc tính Ảnh
Image URL = Địa chỉ URL của Ảnh
Input an image URL = Hãy nhập địa chỉ URL ảnh
Invalid image URL = Địa chỉ URL của ảnh không hợp lệ
Invalid Prefix = Tiền tố không hợp lệ
Failed to load the image = Không tải được hình ảnh
Image URL contains special characters = Địa chỉ URL của ảnh có chứa ký tự đặc biệt
From Web URL = Từ địa chỉ WebL
From Local Computer = Từ máy tính
Please select a png/gif/jpg file. = Vui lòng chọn tệp tin dạng png / gif / jpg.
Please select an image file. = Vui lòng chọn tệp hình ảnh.
Select an image file = Chọn tệp hình ảnh
Insert Image to PCB = Chèn hình ảnh vào bản mạch PCB
Tolerance = Sai số
tolerance = sai số
capacitance = dung khánh
frequency = tần số
Rated Voltage = Điện áp danh định
Rated Current = Dòng hiện thời
resistance = trở kháng
Resistance = Trở kháng
Resistance[Ω] = Trở kháng[Ω]
inductance = cảm kháng
Operating Temperature = Nhiệt độ làm việc
Shape Invert = Đảo ngược hình ảnh
Image Size = Kích thước ảnh
Color Tolerance = Dung sai màu
Simplify Level = Mức đơn giản
Corner Threshold = Giới hạn góc

#PCB Canvas Attributes
Units = Đơn vị
Snap Size = Khoảng cách tự dính
Other = Khác
Routing Width = Chiều rộng đường mạch
[router]
Routing Width = Chiều rộng đường mạch
[/router]
Please using hotkey {0}{shiftw}{1} or {2}{tab}{3} to change track width while on routing. = Hãy sử dụng phím nóng {0}{shiftw}{1} hoặc {2}{tab}{3} để thay đổi độ rộng đường mạch khi đang vẽ mạch. 
Routing Angle = Góc đường mạch
Routing Conflict = Xung đột đường mạch
Remove Loop = Loại bỏ vòng lặp
Cut SilkScreen = Cắt đế linh kiện (SilkScreen)
Grid = Lưới vẽ
Grid 90 = Lưới 90
Grid 45 = Lưới 45
Copper Zone = Khu vực phủ đồng
Visible = Hiển thị
Invisible = Không hiển thị
Ignore = Bỏ qua
Block =  Chặn
RoundTrack = Đi vòng

#Track
Track Properties = Tính chất đường mạch
Layer = Lớp mạch
Net = Mạch
Start X = Điểm bắt đầu X
Start Y = Điểm bắt đầu Y
End X = Điểm kết thúc X
End Y = Điểm kết thúc Y
ID = Mã

#Pad Properties
Pad Properties = Thuộc tính Pad
Shape = Hình dạng
Hole(D) = Đường kính lỗ (D)
Center X = Trọng tâm X
Center Y = Trọng tâm Y
Round = Vòng tròn
Oval = Bầu dục
Hole Shape = Hình dạng lỗ
Slot = Khe
Hole(Length) = Chiều dài lỗ
Plated = Phủ đồng
None = Không
Paste Mask Expansion = Mở rộng điểm dán
Solder Mask Expansion = Mở rộng điểm hàn

#Via Properties
Via Properties = Đặc tính Via
Diameter = Đường kính
Drill Diameter = Đường kính khoan

#Hole Properties
Hole Properties = Đặc tính Lỗ


#TEXT
Text Properties = Đặc tính chữ
Line Width = Chiều rộng dòng
Rotation = Góc quay
Fonts Management = Quản lý Phông chữ

#Dimension Attributes
Dimension Attributes = Thuộc tính kích thước

#Footprint Attributes
Component Attributes = Đặc tính linh kiện
Display Prefix = Tiền tố
Pin Name = Tên Chân 
Pin Number = Số Chân
Spice Pin Number = Số chân linh kiện
Graphics = Đồ họa
Pattern = Kiểu nền

#Arc Properties
Arc Properties = Đặc tính Cung
Start Angle = Góc bắt đầu
End Angle = Góc kết thúc
Rotation Direction = Hướng xoay

#Rect Properties
Rect Properties = Thuộc tính chữ nhật
Round radius = Bán kính bo góc

#Circle Properties
Circle Properties = Thuộc tính đường tròn
Radius = Bán kính

#CopperArea Properties
CopperArea Properties = Đặc tính Vùng phủ đồng
Clearance = Khoảng cách để trắng từ đường mạch
Pad Connection = Kết nối pad
Direct = Trực tiếp
Spoke = Kiểu nan hoa
Keep Island = Cô lập
Fill Style = Kiểu phủ
CopperArea conflict: copper area outlines in same layer with different net names must not overlap = Xung đột vùng phủ đồng: đường bao vùng vủ đồng không được chồng lên đường mạch khác trên cùng một lớp mạch
Copper area rebuild complete! You can set "Copper Zone" as "Visible" at the right-hand property panel after single click the empty area. = Thiết lập xong vùng phủ đồng! Bạn có thể Hiện "Vùng phủ đồng" bằng thanh điều khiển bên phải sau khi nhấn chuột đơn vào vùng trống.
Please create board outline first. = Hãy tạo hình vẽ đường biên bản mạch trước
Board outlines are not closed. = Đường biên của bản mạch không kín
Rebuild CopperArea = Thiết lập lại vùng phủ đồng
Edit Points = Sửa điểm nối
Direct = Trực tiếp
Spoke = Kiểu nan hoa
No Solid = Không phủ kín
Board Cutout = Vùng cắt bản mạch
Solid = Phủ kín
[copperArea]
None = Không có gì
[/copperArea]

#Custom Attributes
Custom Attributes = Đặc tính tùy chỉnh
Fixed Attributes = Đặc tính cố định
Add new parameter = Thêm thông số mới
Add New Parameter = Thêm thông số mới
Add New Supplier = Thêm Nhà Sản xuất mới
Mounted = Gắn
Unknown = không xác định

Custom = Tùy chỉnh
Scan the QR code below and open it on the mobile side = Quét mã QR và mở trên điện thoại
How to create a single layer PCB = Làm thế nào để tạo bản mạch PCB một lớp
Currently doesn't support layout single layer directly, please refer at: = Hiện không hỗ trợ vẽ một lớp trực tiếp, xin tham khảo thêm tại:

#Dialog Register
Create an account = Tạo tài khoản
Username = Tên người dùng
Password = Mật khẩu
Confirm Password = Xác nhận mật khẩu
Email = Thư điện tử
Please read this before you register = Hãy đọc trước khi đăng ký
Hi {username} = Xin chào {username}

#Dialog lostPassword
Lost Password... = Quên mật khẩu...
Find the password using your email = Lấy lại mật khẩu bằng thư điện tử



#Dialog Login
Login = Đăng nhập
Username or Email = Tên người dùng hoặc thư điện tử
Remember Me = Ghi nhớ đăng nhập
Third party = Bên thứ ba
Login and Register = Đăng nhập và đăng ký
Your login information seems expired, please login again. Don't need to close the opening files, you can continue to save them after login. = Thông tin đăng nhập của bạn đã hết hạn, hãy đăng nhập lại. Không cần phải đóng các tập tin đang mở, bạn có thể tiếp tục lưu chúng lại sau khi đăng nhập.

#Dialog Reset Password
Reset a password using your email = Lập lại mật khẩu bằng thư điện tử
Your registered email = Địa chỉ thư điện tử đã đăng ký

#Dialog Reaction
Re-send an activation code to your email = Gửi lại mã kích hoạt qua thư

#Dialog Invite
Invite friends to register = Mời bạn bè đăng ký
Your friend's email = Thư điện tử của bạn bè

#Dialog Add A New Parameter
Add a new parameter = Thêm thông số
Key = Khóa
Value.new_para = Tham số
In BOM = Trong bảng linh kiện (BOM)
Add into BOM = Thêm vào Bảng linh kiện (BOM)
Invalid key = Khóa không đúng
This field is required. = Trường này bắt buộc phải nhập

#Dialog Change Your Password
Change your password = Thay đổi mật khẩu
Old password = Mật khẩu cũ
New Password = Mật khẩu mới
Confirm Password = Xác nhận mật khẩu

#Dialog Create New Design
Save as a New Project = Lưu thành dự án mới
Save as a schematic = Lưu thành bản vẽ mạch (schematic)
Save as Symbol = Lưu thành ký hiệu Linh kiện
Save as a spice Symbol = Lưu dưới dạng biểu tượng linh kiện (Spice)
Save as a spice subckt = Lưu dưới dạng mạch phụ của linh kiện
YOU MUST CREATE A SPICE SYMBOL WITH EXACTLY THE SAME NAME AS THIS SUBCKT = BẠN PHẢI TẠO BIỂU TƯỢNG LINH KIỆN CÓ TÊN ĐÚNG NHƯ SUBCKT NÀY
Save as a PCB file = Lưu dưới dạng tệp PCB
Save as Footprint = Lưu thành mẫu (Footprint)
Save as a Schematic Module = Lưu dưới dạng bản vẽ mô đun
Save as a PCB Module = Lưu dưới dạng mô đun mạch PCB
Save as 3D Model = Lưu thành mô hình 3D
Save as a WaveForm = Lưu thành dạng Sóng (WaveForm)
Title = Tiêu đề
Share = Chia sẻ
Add file = Thêm tập tin
Visibility = Đặc tính Hiển thị
Allow Comments = Cho phép nhận xét
Public (Anyone can see this project but only you can modify it.) = Công khai (Ai cũng xem được nhưng chỉ bạn mới có thể sửa đổi)
Private (Only you can see and modify this project) = Riêng tư (chỉ bạn mới có thể xem và sửa đổi)
Create new project success! = Tạo Dự án mới thành công
You can now create files under this project = Bây giờ bạn có thể tạo các tập tin theo dự án này
This file must be saved under a project, choose other project or create a new project = Tập tin này cần phải được lưu theo một dự án, hãy chọn dự án hoặc tạo một dự án mới.
Please login to save this kind of document = Hãy đăng nhập để có thể lưu loại tài liệu này
Duplicated project title = Tên dự án bị trùng
#Duplicated document title
Project does not exist =Dự án không tồn tại
Document does not exist = Tài liệu không tồn tại
document not exists = tài liệu không tồn tại

Categories = Nhóm
Project = Dự án
Short description = Mô tả ngắn
Content = Nội dung
Modify this project info. = Sửa đổi thông tin dự án.
Modify this file info. = Sửa đổi thông tin của tập tin
Notice = Lưu ý
Search for it before creating a new one. = Hãy thử tìm kiếm trước khi tạo mới.
Manufacturer Part Number = Mã linh kiện của Nhà sản xuất
Supplier = Nhà Sản xuất
Or = Hoặc
Supplier Part = Linh kiện của Nhà cung cấp
Supplier Part Number = Mã linh kiện của Nhà cung cấp
Link = Liên kết
link = liên kết
The professional function please refer at: = Xem thêm hàm chuyên sâu tại: 

#Dialog Clone My Part
#Clone it to a project
#Clone it, then edit it
Clone your file = Nhân bản tập tin

#Dialog Subckt
Attach a Subckt to this spice symbol = Thêm dữ liệu mô hình mô phỏng cho linh kiện này
Subckt string = Chuỗi dữ liệu mô hình
Spice symbol title just allow [0-9][a-z][A-Z] and _=Tên Ký hiệu mô hình mô phỏng chỉ cho phép các ký tự [0-9][a-z][A-Z] và _

#Design Manager
Design Manager = Quản lý Thiết kế
Nets = Mạch
DRC Errors = Lỗi DRC
Are you sure you want to unroute this net? = Bạn có chắc chắn muốn xóa mạch này?
Unroute = Bỏ đường mạch
Track Length = Độ dài đường mạch
Via/Hole Outer Size = Kich cỡ ngoài của lỗ Via/Lỗ
Filter nets = Lọc mạch
Design Rule Checking = Kiểm tra nguyên tắc thiết kế
Board Outline = Bo bản mạch PCB
Plane Zone = Vùng mặt phẳng
[drcRule]
Width = Chiều rộng
DRC Width = Độ rộng DRC 
Length = Chiều dài
DRC Length = Chiều dài DRC 
Drill Diameter = Đường kính lỗ khoan
DRC Drill Diameter = Đường kính lỗ khoan DRC
Diameter = Đường kính
DRC Diameter = Đường kính DRC
Object = Thành phần
DRC Clearance = Khoảng hở DRC
[/drcRule]
#It will take a while to unroute this net, do you want to continue?
More than one netlabel is found in wire, please checked whether this is correct, if you design it on purpose, please ignore this warning. = Có nhiều tên mạch khác nhau trên cùng một đường mạch, hãy kiểm tra lại xem có chuẩn không. Nếu đó là chủ định của bạn, hãy bỏ qua cảnh báo này.
Incomplete net, a complete net should contain two or more pins, if you design it on purpose, please ignore this warning. = Mạch chưa hoàn thiện, mạch hoàn thiện sẽ nối ít nhất 2 chân linhh kiện trở lên. Nếu đó là chủ định của bạn, hãy bỏ qua cảnh báo này.
This netlabel is not connected with any pin. = Tên đường mạch này không nối với chân linh kiện nào.
Incomplete connection, please check. = Kết nối không kín, hãy kiểm tra lại.
The clearance between two objects is less than the Design Rule Checking (DRC) clearance which has different nets. = Khoảng hở giữa 2 thành phần nhỏ hơn mức quy định trong Nguyên tắc thiết kế (DRC) đối với khoảng hở giữa các đường mạch khác nhau.
The diameter is less than Design Rule Checking (DRC) diameter = Đường kính này nhỏ hơn đường kính quy định trong Nguyên tắc thiết kế (DRC)
The drill diameter is less than Design Rule Checking (DRC) drill diameter = Đường kính lỗ khoan nhỏ hơn đường kính quy định trong Nguyên tắc thiết kế (DRC)
The track length is longer than Design Rule Checking (DRC) track length =Chiều dài đường mạch lớn hơn so với quy định trong Nguyên tắc thiết kế (DRC)
The track width is less than Design Rule Checking (DRC) track width =Độ rộng đường mạch này nhỏ hơn so với quy định trong Nguyên tắc thiết kế (DRC)

#Dialog Simulation
Show your simulation report = Hiển thị báo cáo mô phỏng
Download netlist = Tải xuống danh sách đường mạch
Run = Thực thi
Components = Linh kiện

#Dialog Import
Import file from your computer = Nhập tệp từ máy tính của bạn
Maximum file size: 30 MB = Kích thước tệp tối đa: 30MB
Maximum file size: 100 MB = Kích thước tệp tối đa: 100MB
Chose file = Chọn tệp
File Operation = Thao tác tệp
Import File = Nhập tệp tin
Extract Libs = Trích xuất các tệp thư viện
Import File and Extract Libs = Nhập tập tin và Trích xuất thư viện
File type = Loại tệp
The file size is too large. = Kích thước tệp quá lớn
Please selected the file type. = Vui lòng chọn loại tệp
No component was found! = Không tìm thấy linh kiện
Import successfully = Nhập thành công
Import failed = Nhập không thành công
Click OK to continue with the import = Nhấn OK để tiếp tục quá trình nhập
Select None = Không chọn gì cả

#Dialog Modify Symbol Information
Modify symbol information = Sửa đổi thông tin linh kiện
Spice Prefix = Tiền tố mô phỏng linh kiện (Spice)
Hide Pin = Ẩn chân Linh kiện
Pin Manager = Trình quản lý Chân linh kiện
When a power pin is hidden, it will be marked as netlabel, you don't need to wire it. If you use it as simulation, please show it or create a GND/VCC Net for it. = Khi một chân nguồn bị ẩn, nó sẽ được đánh dấu là nhãn đường mạch, bạn không cần phải nối mạch với nó. Nếu bạn dùng nó cho Mô phỏng, hãy hiển thị nó hoặc tạo ra tên mạch GND/VCC cho nó.
Assign = Ấn định
Supplier.bom = Nhà Sản xuất linh kiện
LCSC.bom = Số LCSC
Price = Giá
Quantity.bom = Số lượng
Package.bom = Kiểu
Components.bom = Tên linh kiện
Manufacturer Part.bom = Mã số
Manufacturer.bom = Nhà sản xuất

One-click Purchasing at LCSC = Nhấn để mua Trung tâm mua sắm LCSC (Li Chong)
Order Parts/Check Stock = Đặt hàng/ Kiểm tra kho hàng
Export BOM = Xuất bảng linh kiện
Export PCB BOM = Xuất bảng mạch
Export Schematic BOM = Xuất bản vẽ
ID.bom = Mã
Name.bom = Tên
[bom]
Name = Tên
LCSC Assembly = Dây chuyền sản xuất LCSC 
Value = Trị số
ID = Mã
Supplier = Nhà Cung cấp
LCSC = Mã LCSC
Price = Giá
Quantity = Số lượng
Package = Kiểu
Components = Tên linh kiện
Manufacturer [/bom]= Nhà sản xuất [/ bom]
Manufacturer Part = Mã linh kiện của nhà sản xuất

#Dialog Run
Run your simulation = Chạy mô phỏng
Transient = Tức thời
Maximum Timestep = Nhịp thời gian tối đa
Stop Time = Bắt đầu
Start Time = Kết thúc

AC Analysis = Phân tích AC
Type of Sweep = Kiểu quét
Number of points = Số điểm
Start Frequency = Tần số bắt đầu
Stop Frequency = Tần số kết thúc

DC sweep = Quét DC
Source to Sweep = Nguồn quét
Start Value = Giá trị ban đầu
Stop Value = Giá trị kết thúc
Increment = Nhịp tăng
DC Transfer = Chuyển DC
Output = Đầu ra
Source = Nguồn

DC op pnt = op pnt điện một chiều
Compute the DC operating point treating capacitances as opens and inductances as shorts =  Tính toán các điểm một chiều DC, coi dung kháng là mở và cảm kháng là đóng

#Dialog Share Info
Active File = Tài liệu hiện tại
Active Project = Dự án hiện tại
Readonly = Chỉ đọc
Editable = Có thể chỉnh sửa được
Active file's owner project page = Trang dự án của chủ sở hữu tập tin gốc
Active project editor page = Trang soạn thảo thông tin về dự án

#Dialog Document Recovery
All Projects = Tất cả Dự án
Document Recovery = Phục hồi tài liệu
Unsaved files = Tài liệu chưa được lưu
Please select a file! = Hãy chọn một tập tin!
Please expand the folder first, then select a document to recover. = Hãy mở thư mục trước, sau đó chọn một tài liệu để khôi phục.
Are you sure you want to remove this backup? = Bạn có chắc chắn muốn xóa bản sao lưu này?

#Dialog Find Libs
Search = Tìm kiếm
Search Results = Kết quả tìm kiếm
Search and press Enter = Nhấn Enter để tìm kiếm
Keywords at least 3 characters = Từ khóa cần có tối thiểu 3 ký tự
Assembled = Đã đóng gói
Verified = Đã xác minh
In stock = Đang còn hàng
{page} of {pagecount} pages = Trang {page} / trang {pagecount}
Common Modules = Mô đun phổ biến
User Contributions = Đóng góp của người dùng
More = Thêm
Add Favorite = Thêm vào Mục yêu thích
Remove Favorite = Xóa khỏi mục yêu thích
Add Sub Part = Thêm thư viện con
Untagged = Không gắn nhãn
Package = Kiểu đóng gói
package = kiểu đóng gói
Title(PartNO) = Tiêu đề (Tên linh kiện)
No Data! = Không có số liệu!
Quantity = Số lượng
Manufacturer Part = Linh kiện của Nhà sản xuất
manufacturer Part = linh kiện của Nhà sản xuất
Manufacturer [/ bom]= Nhà sản xuất [/ bom]
manufacturer = nhà sản xuất
voltage = Điện áp
Library = Thư viện
LCSC Assembled = Đóng gói tại LCSC (Li Chong)
JLCPCB Assembled =Đóng gói tại JLCPCB
User Contributed = Đóng góp của người dùng
Symbol = Ký hiệu linh kiện
Follow = Quan tâm
Types = Kiểu
Classes = Lớp
power = nguồn điện
Power = Nguồn điện
LCSC Part# = Trung tâm mua sắm linh kiện LCSC (Li Chong)
Stock [lib]= Còn hàng [lib]
Report Error... = Báo cáo lỗi...
Report Error =Báo cáo lỗi
Thanks for your feedback! = Cảm ơn ý kiến phản hồi của bạn!
Report error success, thanks for your report! = Báo cáo lỗi thành công, cảm ơn bạn đã báo cáo!
The content must be at least 2 characters! = Nội dung này phải có ít nhất 2 ký tự!
This library is user contributed, please check before using. = Thư viện này là do người dùng cung cấp, hãy kiểm tra kỹ trước khi dùng.
[lib]
All = Tất cả
System = Trong Hệ thống
Personal = Cá nhân
Created = Đã tạo
Favorite = Yêu thích
No Team found. Please join or create a team first. = Không tìm thấy Nhóm nào. Hãy tham gia hoặc tạo ra một nhóm trước.
Create a team = Tạo nhóm
No follow user found. Please follow your friend first. = Không có ai theo dõi. Hãy theo dõi bạn của bạn trước đã.
[/lib]


BUY = MUA
In Stock = Đang còn hàng
Out of Stock = Hết hàng
Minimum = Đơn tối thiểu
Distributor = Người phân phối

Capacitance = Dung kháng
Frequency Tolerance = Dung sai vè tần số
Power (Watts) = Công suất nguồn (W)
Power - Max = Nguồn - Tối đa
Frequency = Tần số
Voltage Rating(Vdc,Vac) = Điện áp danh định(Vdc,Vac) 
Voltage = Điện áp
Current Rating = Đong hiện thời
Rated current = Dòng danh định
Resistance (Ohms) = Trở kháng (Ohms)
Resistance(Ohms) = Trở kháng (Ohms)
Inductance = Cảm kháng
FET Type = Loại FET
Current Rating(Max) = Dòng danh định (tối đa)
Impedance @ Frequency =  Trỏ kháng @ Tần số
Voltage - Input (Max) = Điện áp - Vào (Tối đa)
Voltage - Input (Min) = Điện áp - Vào (Tối thiểu)
Voltage - Supply = Điện áp - Nguồn
Voltage - Max = Điện áp - Tối đa
Current - Output = Dòng - Ra

#Dialog Export Your Works
Export your works = Xuất sản phẩm của bạn
Export to = Xuất tới
Zoom = Phóng to
Image Type = Loại hình ảnh
Qualify = Chất lượng
0 means real size = 0 ứng với kích thước thực tế
Merged layer = Ghép lớp
Separated layer = Tách lớp
Paged layer = Phân lớp theo trang
Layer = Lớp
Export = Xuất
Mirror = Ánh xạ
TopLayer = Lớp trên
BottomLayer = Lớp dưới
TopSilkLayer = Lớp đế linh kiện trên
Protractor Attributes = Đặc tính góc
BottomSilkLayer = Lớp đế linh kiện dưới
BoardOutLine = Đường bao bảng mạch
TopAssembly = Lớp lắp ráp trên
BottomAssembly = Lớp lắp ráp dưới
Mechanical = Lớp thao tác cơ khí
DocumentLayer = Lớp thông tin
Inner{number} = Bên trong{number}
Substrate{number} = Nền{number}
Color = Màu
Full Color = Màu đầy đủ
Canvas Setting = Cài đặt nền vẽ
Full Graphics = Đồ họa đầy đủ
Assembly Drawings = Bản vẽ sơ đồ lắp ráp
Object Outlines = Tổng quan linh kiện
Invalid file format = Định dạng tệp không hợp lệ
Failed to export file = Xuất tệp không thành công
Download now = Tải xuống ngay
Wire Width = Chiều rộng đường mạch
Sheet = Trang bản vẽ
Merged sheet = Hợp nhất trang
Separated sheet = Tách trang
Engine = Nền tảng
Exporting PDF = Xuất ra PDF
Export 3D Model = Xuất mô hình 3D
[exportDocument]
Size = Kích thước
[/exportDocument]

#Dialog Import Changes
Confirm Importing changes information = Xác nhận Nhập những thay đổi
You can't undo this operation, Please run a Design Rule Checking (DRC) after this operation. = Bạn không thể hoàn tác hành động này. Hãy chạy lệnh Kiểm tra nguyên tắc thiết kế (DRC) sau khi thực hiện hành động này.
Apply Changes = Thực hiện thay đổi
This is a simple Design Rule Checking (DRC). = Đây là lệnh Kiểm tra nguyên tắc thiết kế (DRC) đơn giản.
It just can help you to find the obvious errors = Chỉ để giúp bạn tìm ra một số lỗi rõ ràng
There are some unfinished nets, do you want to check the nets first? = Có một số đường chưa hoàn thiện, bạn có muốn kiểm tra đường mạch trước không?
Yes, Check Nets = Có, Kiểm tra
No, Keep Going = Không, đi tiếp

#Dialog Layer Manager
Configured = Đã thiết lập
Layer Name = Tên lớp
TopPasterLayer = Lớp phủ trên
BottomPasterLayer = Lớp phủ dưới
TopSolderLayer = Lớp hàn trên
BottomSolderLayer = Lớp hàn dưới
TopPasteMaskLayer = Lớp đánh dấu trên
BottomPasteMaskLayer = Lớp đánh dấu dưới
TopSolderMaskLayer = Lớp đánh dấu hàn trên
BottomSolderMaskLayer = Lớp đánh dấu hàn dưới
ComponentShapeLayer = Lớp phác hình linh kiện
LeadShapeLayer = Lớp tiếp giáp
ComponentMarkingLayer = Lớp đánh dấu linh kiện
Ratlines = Đường phác kết nối linh kiện
Ratlines Color = Màu đường phác
Manage Colors = Quản lý màu
BoardOutline = Đường bao bo mạch
Multi-Layer = Nhiều lớp
Hole = Lỗ
DRCError = Lỗi DRC
Setting = Thiết lập
Drawing area = Khu vực vẽ
Export area = Khu vực xuất
Transparency(%) = Độ trong suốt (%)
Copper Layer = Lớp phủ Đồng
Signal = Tín hiệu
Plane = Mặt phẳng
Non-Signal = Không có tín hiệu
Other = Khác
Please delete all the objects of the layers first! The layers are: = Hãy xóa tất cả các đối tượng tại các lớp trước! Các lớp gồm: 
You are converting Signal Layer to Plane Layer, There're some non-track objects remain on following layers. Please delete the objects manually on the canvas. = Bạn đang chuyển Lớp tín hiệu sang mặt phẳng, Có một số đối tượng không có đường mạch vãn còn trên các Lớp. Hãy xóa chúng bằng tay trên nền vẽ.
Please delete all the objects of this layer first! = Hãy xóa các đối tượng trên Lớp này trước!

#Dialog Fabrication Output
Create Files = Tạo tập tin
Check your {0}Gerber files{1} carefully before sending them to the factory = Trước khi đến nhà máy, kiểm tra lại {0} tệp Gerber {1}
Download free Gerber Viewer (gerbv) = Tải trình xem tệp Gerber (gerbv) miễn phí
Before generating the Gerber files = Trước khi tạo tệp Gerber
Please check the packages size and orientation carefully. = Hãy kiểm tra cẩn thận kích thước linh kiện và chiều sắp xếp chúng thật cẩn thận.
Please check for Design Rule Checking (DRC) errors in the Design Manager. = Hãy kiểm tra các lỗi vi phạm Nguyên tắc thiết kế (DRC) trong trình thiết kế.
Please rebuild the copper area after modifying tracks and packages. = Hãy dựng lại vùng phủ đồng sau khi thiết lập đường mạch và linh kiện.
After generating the Gerber file, please use the {0}Gerber Viewer{1} to check whether it conforms to the design requirements. = Sau khi tập tin Gerber được tạo ra, sử dụng trình xem {0} tệp Gerber {1} để xem tệp Gerber có đáp ứng các yêu cầu thiết kế
Order PCB/SMT at JLCPCB = Đặt mua PCB/SMT tại JLCPCB
Found the complicated polygon object can not be generated at Gerber, please remove or replace = Phát hiện đối tượng đa giác phức tạp không thể tạo ra được trên tệp Gerber
ID: {id}, Object: {object}, Location: {location} = Mã: {id}, Đối tượng: {object}, Vị trí: {location} 

#Dialog DRC
Item = Mục
Value = Giá trị
value = giá trị
Unit = Đơn vị
Track Width = Chiều rộng đường mạch
Track to Track = Giữa các đường mạch
Track to Pad = Giữa đường mạch đến pad
Pad to Pad = Giữa các Pad
Via to Via = Giữa các Via
Via Hole Size = Thông qua đường kính
Realtime DRC = Thời gian thực kiểm tra quy tắc thiết kế
{0} is too small! = Phát hiện quy tắc thời gian thực
Invalid DRC Rule =
Rule =
Via Diameter =
Via Drill Diameter =
Net List =
Rule =
Set Rule =
Check Object to Copper Area =
Show DRC Boundary while Routing =
Check Object to Board Outline =
Rule name already exists! =
You should not delete default rule! =
Rule list contains invalid rule setting! =
Duplicate rule name exists! =
via diameter is smaller than via drill diameter! =
Currently rule name is not allowed to contain magical characters like . and $ =
[drcRule]
All = Tất cả
[/drcRule]

#Dialog  Update PCB
Update PCB(Synchronizing PCB from schematics) = Cập nhật PCB (Synchronous Schematic và PCB)


#Dialog Hotkey
Change Canvas Unit =
Copy Selected Object(s) by Reference Point =
Fullscreen =
Undo the Previous Draw =
Set Canvas Origin by Coordinate =
Switch to the Next Signal Layer =
Switch to the Previous Signal Layer =
Switch object to top layer or bottom layer =
Cycle Forward to the Next Open Tabbed Document =
Cycle Backward to the Previous Open Tabbed Document =
Switch to the Previous Layer(on the Numeric Keypad) =
Switch to the Next Layer(on the Numeric Keypad) =
Toggle Layers Which is Not Active =
Hotkey Setting = Cài đặt phím nóng
Document Type = Loại tài liệu
Shortcut =
Function =
ALL = Tất cả
SCH = Sơ đồ
Rotate Selected Objects =
Scroll or Move Selected Left =
Scroll or Move Selected Right =
Scroll or Move Selected Up =
Scroll or Move Selected Down =
Set canvas origin to the center grid of graphics in symbol; Set canvas origin to the center of pads in footprint. =
Cross Document Paste = Dán chéo tài liệu
Explore & Find Components = Duyệt và tìm các thư viện thành phần
Select All = Chọn tất cả
Cancel Current Drawing =
Save = Lưu lại
Drag Tool = Kéo
Draw Wire = Vẽ dây
Draw Bus = Vẽ xe buýt
Bus Entry = Entry Bus
Junction = Nút nối
Net Flag GND =
Net Flag =
Draw Polyline = Vẽ đường thẳng
Draw Polygon = Vẽ đa giác
Draw Bezier = Vẽ Bezier
Draw Arc = Vẽ đường cong
Draw Rect = Vẽ Rect
Draw Ellipse = Vẽ hình bầu dục
Freehand Draw = Vẽ tự do
Freedraw =
Draw Text = Vẽ văn bản
Edit Selected Symbol = Sửa đổi thiết bị đã chọn
Draw Track = Vẽ dây
Draw Circle = Vẽ một vòng tròn
Cycle Select Object at Current Location =
Draw Dimension = Vẽ kích thước
Draw Connect = Vẽ cáp
Draw CopperArea = Vẽ đồng
Change to TopLayer;<br/>Change Selected Component's Layer to TopLayer; =
Change to BottomLayer;<br/>Change Selected Component's Layer to BottomLayer; =
Change to Inner1 =
Change to Inner2 =
Change to Inner3 =
Change to Inner4 =
Highlight Net = Đánh dấu web
Place Pad = Đặt miếng đệm
Place Via = Đặt lỗ
Measure = Đo khoảng cách
Change Routing Angle = Thay đổi góc dây
Change Routing Conflict =
Decrease Routing Width = Giảm chiều rộng đường kẻ
Increase Routing Width = Tăng chiều rộng đường kẻ
Decrease Snap Size = Giảm kích thước lưới
Increase Snap Size = Tăng kích thước lưới
Change Copper Zone Visible or Invisible =
Rebuild All Copper Area = Tái thiết đồng
Toggle PCB Net Display = PCB Net hiển thị mạng
Show Attribute Dialog When Placing Object;<br/>Show Location Setting Dialog When Pasting Object(s) =
Show Attribute Dialog When Placing Object;<br/>Show Absolute Offset Dialog When Selecting Object(s);<br/>Show Location Setting Dialog When Pasting Object(s) =
Show Relative Offset Dialog When Selecting Object(s) =
Open the FAQ Page =
Move Object(s) by Reference Point =
Choose Favorite Track Width While Routing =
Copy Selected Object(s) and Paste Repeatedly =

#My Projects Tree Menu
New Project = Xây dựng mới
New Schematic = Sơ đồ mới
New PCB = Mới PCB
New Spice Subckt = Mạch mô phỏng mới
Modify = Chỉnh sửa
Delete = Xóa bỏ
Add sub part = Thêm thiết bị phụ
Clone = Clone
Version History = Phiên bản lịch sử
Refresh List = Làm mới danh sách
Create New Project = Tạo dự án mới
Delete = Xóa bỏ
Attachment =
Archive =
Transfer =
Manage Project =

#Dialog Verify Package
Footprints Verification =

#Dialog Edit Polygon Pad points
Edit Points = Gói kiểm tra
Center point is outside the pad =
Hole should be inside the pad =
Hole is draggable =

#My Part Tree Menu
Clone = Clone
Reload parts = Tải lại
Layers = Lớp

#Dialog Preferences
Language = Ngôn ngữ
Display Name = Hiển thị tên
HotKey Sync = Đồng bộ hóa phím nóng
My Theme Sync =
Document Recovery Setting = Cài đặt sao lưu
Enable auto backup =
Maximum backup level = Số lượng sao lưu tối đa
Auto backup interval =
minutes =
Save to Server = Lưu vào máy chủ
Load from Server = Tải từ máy chủ


#Dialog Schematic Library Wizard
Symbol Wizard =
Style = Phong cách
Picture = Hình ảnh
Pin Names = Tên pin
Contributor = Người đóng góp
contributor = Người đóng góp
owner =

#Dialog Annotate
Annotate = Đánh dấu
Scope = Phạm vi ứng dụng
Active Schematic only = Chỉ có sơ đồ mạch
All Opened Schematics = Tất cả các sơ đồ mở
Method = Phương pháp
Re-annotate all = Đánh dấu lại
Keep existing annotation = Giữ nhãn ban đầu
Direction = Hướng
Rows = Hàng
Cols = Cols
Reset = Cài lại

#Dialog Order
Order... = Đặt hàng...
PCB Qty. = PCB Số lượng.
PCB Thickness = Độ dày PCB
PCB Dimension = Kích thước PCB
Automatic calculation = Tính tự động
PCB Color = Màu PCB
Green = màu xanh lá
White = Trắng
Blue = Màu xanh da trời
Red = Đỏ
Yellow = Màu vàng
Black = Đen
Purple = Màu tím
Copper = Đồng
Gold = Vàng
Silver = Bạc
Surface Finish = Bề mặt hoàn thiện
Hasl = Có Chì
Hasl(Lead Free) = Không chì
ENIG = Chìm vàng

#Dialog Hot Key config
Restore All Default Shortcuts = Khôi phục lại tất cả các shortcut mặc định
Save Changes = Lưu thay đổi



#Dialog Polyline Maybe Wire
To connect electrical elements, please use Wire (W hotkey) and not Line (L hotkey). = Thay vì một đường thẳng (phím tắt L), sử dụng một dây (phím tắt W) để nối nút điện.

Anonymous File =
Anonymous File can not be cloned, but you can open it, then save it as a new file. =
Free Documents =
You must close the file before delete it! = Xin vui lòng xóa các tập tin trước khi xóa!
Offline Project =

#Message box
Confirmation = Xác nhận
Alert = Cảnh báo
Information = Thông tin
information = Thông tin
Prompt = Lời nhắc
Error = lỗi
error = lỗi
error! = lỗi
Warning = Cảnh báo
Imported ok! = Nhập thành công
Some changes have not been saved. = Sửa đổi tài liệu chưa được lưu
Your file hasn't been saved. Please save first! = Tài liệu của bạn chưa được lưu, vui lòng lưu!
Your file hasn't been saved. Are you sure you want to close it? = Tài liệu của bạn chưa được lưu, chắc chắn đóng nó?
Error! Please try again later. = Đã xảy ra lỗi! Vui lòng thử lại sau.
Are you sure you want to reload this page? = Bạn có chắc chắn muốn tải lại trang hiện tại không?
Are you sure you want to leave this page? = Bạn có chắc chắn muốn thoát khỏi trang hiện tại không?
Confirm Reload = Xác nhận tải lại
Confirm Close = Xác nhận để đóng
Reload this page =
Leave this page = Rời khỏi trang
Stay on this page = Ở trên trang này
Don't reload = Không tải lại
No connect flag only can be placed on Pin dot or the wire which is connected one Pin. =
can not be placed on the wire which is placing No Connect Flag. =
The footprint transfer to LCSC library class successfully =
Device/Footprint goes into "SMT Device/Footprint Verified" list successfully =

Load failure! = Không thể tải
Load projects failed = Không thể tải danh sách dự án
error info = Thông báo lỗi
error information = Thông báo lỗi
Guest can't create a new project. Please login! = Khách không thể tạo dự án mới, vui lòng đăng nhập trước tiên
Please create a project before you do this! = Hãy tạo một dự án mới trước khi thực hiện hoạt động này
Add Part success =
Click the new part and then edit it! = Nhấp vào thư viện con mới được thêm vào và chỉnh sửa nó
Delete my work = Xóa công việc của tôi
Delete my work. (Only deletes it from this list but not from the server) = Xóa tài liệu (chỉ xóa khỏi danh sách, tài liệu đã không được thực sự xóa)
Do you confirm this? = Bạn có xác nhận các hoạt động?
Successfully deleted! = Đã xóa thành công
Successfully Copied! =
Cloning success! = Clone thành công!
Your title is too short! = Tiêu đề tài liệu của bạn quá ngắn
Remove this part = Xoá tệp này
Find and Jump to ... = Tìm và nhảy sang thiết bị ...
Please type the prefix, such as U1, R1, C1 = Nhập số nhận dạng của thiết bị, chẳng hạn như U1, R1, C1
Zoom as 1:1, you can print it and then create artwork for etching the PCB. = Thu phóng 1: 1, bạn có thể in tệp, và sau đó tự khắc PCB
Exporting your works! = Xuất khẩu công việc của bạn
Guests can't import a file. Please login! = Khách truy cập không thể nhập tệp tin, vui lòng đăng nhập trước!
Please create a project before you import a file! = Nhập tệp tin trước khi tạo dự án
Import your LTspice file! = Nhập tệp LTspice của bạn!
Open LTspice file =
Please make sure the selected LTspice file is a file saved in LTspice V and above. =
Saved successfully! = Lưu thành công
Save failed! = Lưu thất bại
Can not place parts into this document. = Không thể đặt thiết bị trong tài liệu này, các loại tài liệu không khớp
User Package = Gói người dùng
System Package = Gói hệ thống
File error = Lỗi tệp
Please save your file first! = Hãy lưu tệp của bạn trước tiên
Email address is too short! =
You have not selected a file to upload. = Địa chỉ e-mail quá ngắn
Update = Đã cập nhật
Import.Import Changes =
No changes, the PCB already matches the schematic! =
Only public files can be shared = Chỉ có thể chia sẻ các tệp tin công khai. Tệp hiện tại là tệp cá nhân
Conversion to PCB has failed! = Chuyển đổi PCB không thành công
Your username is too short! = Tên người dùng quá ngắn
Your password is too short, it must be more than 6 characters! = Mật khẩu quá ngắn và phải lớn hơn 6 ký tự
Conflicting shortcut = Xung đột quan trọng
There is an empty PCB file. Please first run Convert Schematic to PCB... from the schematic = Đây là một PCB trống, xin vui lòng mở schematic để chạy "schematic để PCB
This file has been modified, are you sure you want to run this simulation before saving it first? = Tài liệu đã được sửa đổi, bạn xác nhận mô phỏng? Có lẽ bạn nên lưu nó
Please enter the Maximum Timestep! = Vui lòng điền vào bước lớn nhất
Please enter the Stop Time! = Vui lòng điền vào ngày hết hạn
All of these fields are needed. = Tất cả các tùy chọn phải được hoàn thành
Either your spice netlist is too big or the server is busy. Please try again later. = Bảng mạng Spice của bạn quá lớn hoặc máy chủ quá bận để thử lại sau
Your spice netlist is too big! Try breaking your circuit into smaller simulatable blocks. = Spice mạng của bạn bảng là quá lớn, xin vui lòng chia nhỏ mạch vào mô phỏng mạch tiểu
Too many users in simulation. Please try again later! = Quá nhiều người dùng đang chạy mô phỏng và sẽ thử lại sau
Due to limited server resources, please wait 10 seconds for the interval in every time simulation. =
Your circuit is too complex, we have not enough CPU resource to support this simulation, please reduce your circuit as small as you can. =
Simulation is queuing, try again after 30s. =
Timeout =
Demo accounts don't support simulation, please login first = Không cho phép mô phỏng tài khoản demo, vui lòng đăng nhập
Please login first = Vui lòng đăng nhập trước
The schematic is showing errors, please check the simulation report carefully! = Dường như một số sai lầm trong mạch này, xin vui lòng đọc báo cáo mô phỏng một cách cẩn thận, hãy thử tìm ra những sai lầm này.
Simulation too long, maybe your schematic is too complex. = Emulation timeout, có lẽ mạch của bạn quá phức tạp.
Non-simulated file =
This file can only be opened in standard mode. To open it, please switch to standard mode. =
Load your preferences success! = Tải tùy chọn cá nhân của bạn thành công!
Save your preferences success! = Lưu tùy chọn cá nhân của bạn thành công!
Update subckt ok! = Cập nhật tiểu mạch là thành công.
Clone your file = Sao chép tệp
Please type a new file name = Vui lòng nhập tên tệp mới
Create file failure! = Không thể tạo tệp
Schematics and PCBs can't be imported under My Libs folder, please choose a different folder = Schematic và PCB không thể được nhập vào thư mục My Libs, vui lòng chọn một thư mục khác
Libraries to be imported under My Libs folder = Các tệp thư viện chỉ có thể được nhập vào thư mục My Libs
Please choose only the libraries needed = Vui lòng chỉ chọn các tệp thư viện yêu cầu
Maximum import is 200 libs at one time! = Chúng tôi không hỗ trợ nhập hơn 200 tệp thư viện cùng một lúc
You libraries will be found under the My Libs folder = Các tệp thư viện của bạn sẽ xuất hiện trong thư mục My Libs
Add to Library = Thêm vào thư viện
No items have been checked! = Không kiểm tra bất kỳ thiết bị!
Nothing was found, please create it for yourself = Không tìm thấy gì, bạn có thể tự tạo nó
Search result = Kết quả tìm kiếm
At least 3 characters needed = Ít nhất 3 chữ cái tiếng Anh
Add to my Favorite Parts = Thêm vào yêu thích của tôi
Added it OK. Please find it in your Favorite Parts = Thêm thành công, hãy kiểm tra các thiết bị yêu thích của bạn
Please select its parent node = xin vui lòng chọn nút gốc của nó
Libraries can not be exported as active project pdf. = Không thể xuất tệp tin thư viện thành tệp PDF dự án
Error:No GND =
This circuit does not have GND. Please select GND from the circuit tool to add to the circuit. =
Current circuit doesn't has Voltage Resource or Current Resource symbol, please place it first at left side EElib or Spice Library. =
Probe can not connect with ground(GND)! =
Spice symbols's attributes can't be empty. =
Error:No Spice Symbol =
Simulation limit =
There is a multimeter in the circuit that needs to be simulated using the emulation command .tran or .op =
An oscilloscope exists in the circuit and needs to be simulated using the simulation command .tran =
There are components in this circuit that do not have a simulation model. Please use the base library component of the simulation mode for simulation. =
Circuit does not have a probe = Vi mạch không có một thăm dò
Make sure your pin numbers are even numbers = Đảm bảo số pin của bạn là số
Duplicate Components Prefix = Chú thích thiết bị lặp lại
All components are hidden successfully! =
All ratlines are hidden successfully! =
Hidden the ratline of net {netName} successfully! =
Duplicate Component Prefix =
{0} exist = Đã tồn tại
There are some invalid packages, are you sure? = Một số gói không hợp lệ, bạn xác nhận thao tác?
Invalid Characters, library only allows [0-9a-zA-Z-_]
Annotation success = Dán nhãn thành công
If you accept this annotation operation, please save your files. If not, close your files without saving. = Nếu bạn chấp nhận hoạt động ghi nhãn, hãy lưu tệp của bạn, nếu không, đóng tệp của bạn trực tiếp và không lưu tệp.
This file can't be saved under libs project. Please choose other project or create a new project = Không thể lưu tài liệu trong dự án thư viện, hãy chọn dự án khác hoặc tạo một dự án mới
Your file is unsaved. = Tài liệu của bạn không được lưu
You can close the editor now. Have a good day! = Bây giờ bạn có thể đóng trình biên tập và chúc bạn một cuộc sống hạnh phúc!
Successfully logged out = Đăng xuất thành công
You have at least one unsaved file open. Please save it or close it. = Bạn có ít nhất một tài liệu không được lưu, vui lòng lưu nó hoặc đóng nó
Please select a reference point =
Please save your file before this operation = Vui lòng lưu văn bản trước khi tiếp tục
Please open a PCB document = Xin vui lòng mở một tài liệu PCB
Please save your file before '{0}'. = Vui lòng lưu tệp của bạn trước khi thực hiện {0}
Please try again after saving this file. = Lưu tài liệu và thử lại
This text can not be empty! =
Export to Altium fail, please try again or contact us. =
Connecting to server = Kết nối với máy chủ
Please login before asking for help = Vui lòng đăng nhập trước khi yêu cầu trợ giúp
This file has been modified, please save it first! = Tài liệu này đã được sửa đổi, xin lưu trước!
Remove this param = Loại bỏ tham số này
You cannot drag a part to the canvas, please click the part and move the cursor to the canvas and then right-click to place. =
Undo/Redo temporary error = Hoàn tác / làm lại lỗi tạm thời
We are sorry but there is an unpredictable error in the undo/redo process. This problem will be fixed soon but in the meanwhile it is safe to continue working on your design. =
The schematic has duplicate prefixes of the components, please make them unique. You can check them using the Design Manager. = Có một số phần trùng lặp cho sơ đồ hiện tại, sửa đổi chúng và đảm bảo chúng là duy nhất. Bạn có thể xem chúng trong Quản lý Thiết kế
Found duplicated prefix components, can not Import Changes, please modify the duplicated prefix or delete related component. =
Please click the below help button to find out how to fix this problem. = Vui lòng nhấp vào nút trợ giúp bên dưới để tìm hiểu cách khắc phục lỗi này
Please create a board outline! Click the help button to find out how to create a board outline. = Xin vui lòng tạo ra một biên giới PCB đầu tiên và nhấp vào nút Trợ giúp để tìm hiểu làm thế nào để tạo ra một biên giới PCB
Can not fetch files from server, please check your network and try again = Không thể thử lại sau khi kiểm tra mạng từ máy chủ hoặc tài liệu
Please open a schematic first! = Xin vui lòng mở một schematic.
Can not find the schematic of this PCB = Không thể tìm schematic của PCB này
invalid points! = Chứa các điểm tọa độ không hợp lệ
This file does not support this operation. = Tài liệu này không hỗ trợ hoạt động này
Net Name Conflict = Mâu thuẫn về tên mạng
Net name = Tên mạng
{0} are in the same wire, please remove others and just keep one. = {0} Trong cùng một dây, xin vui lòng xóa các khác, chỉ để lại một
This field can't be removed! = Không thể tìm thấy PCB tương ứngbschematic
Annular ring of the pad/via is too small = Conductive lỗ hoặc lỗ cắm một vòng hàn đơn là quá nhỏ
The size of the hole cannot exceed the size of the pad =
Are you sure you want to create a multi-sheet designs? = Bạn có chắc chắn muốn tạo một dự án nhiều trang sơ đồ?
Are you sure you want to create a {0}multi-sheet designs{1}? = Bạn có chắc chắn muốn tạo một {0} Dự án Nhiều Trang Schematic {1}?
Please build the copper area! Click the help button to find out how to build the copper area. = Vui lòng xây dựng lại lớp đồng, nhấp vào nút trợ giúp để biết thêm thông tin
Suggest to set a package for this component first! =
Please select an opened document first. = Trước tiên hãy chọn một tài liệu mở
Some files failed to load. Please reload the page. = Tải tệp từng phần không thành công, vui lòng tải lại trang.

#UI Intro
Skip = Bỏ qua
« Back = «Trước
Next » = Tiếp theo »
Done = Hoàn thành
This is the user management menu. = Đây là menu người dùng
This is the toolbar. = Đây là thanh công cụ hàng đầu
This is the navigation list. Under here you can find projects, files, parts and libraries. = Đây là điều hướng tài liệu, xem các dự án, tài liệu, thư viện ở đây.
Show or hide the toolbar to the top of the window here. = Đây là thanh công cụ trên cùng
Show, resize or hide the left sidebar to the left of the window here. = Đây là công tắc bật tắt bên trái
Show or hide the right sidebar to the right of the window here. = Đây là công tắc bật tắt bên phải

#Standard libs
Passive Components = Thiết bị thụ động
Power Supply = Điện
Diodes = Điốt
Regulator = Bộ điều chỉnh
Transistor = Bóng bán dẫn
Transformers = Biến áp
Gates = Cổng logic
Vacuum Tubes = Ống chân không
Switch = Chuyển đổi
Relay = Chuyển tiếp
Capacitor(US) = Tụ (Mỹ)
Capacitor(EU) = Tụ (Châu Âu)
Capacitor(EU)2 = Tụ (Châu Âu)2
Electrolytic Capacitor(US) = Tụ điện điện (Mỹ)
Electrolytic Capacitor(EU) = Tụ điện điện (Châu Âu)
Electrolytic Capacitor(US)2 = Tụ điện điện (Mỹ)2
Electrolytic Capacitor(EU)2 = Tụ điện điện (Châu Âu)2
Inductor(US) = Tự cảm (Mỹ)
Inductor(EU) = Tự cảm (Châu Âu)
Potentiometer_US =
Potentiometer_EU/IEC =
Potentiometer_3D =
Resistor(US) = Điện trở (Mỹ)
Resistor(EU) = Điện trở (châu Âu)
Resistor 45 Deg(US) = 45 độ kháng (Mỹ)
Resistor 45 Deg(EU) = 45 độ kháng (châu Âu)
Variable Capacitor(US) = Điều chỉnh dung (Mỹ)
Variable Capacitor(EU) = Điều chỉnh dung (châu Âu)
Variable Resistor(US) = Điều chỉnh điện trở (Mỹ)
Variable Resistor(EU) = Điều chỉnh điện trở (châu Âu)
Variable Inductor(US) = Điều chỉnh độ tự cảm (Mỹ)
Variable Inductor(EU) = Điều chỉnh độ tự cảm (châu Âu)
Varistor = Varistor
Inductor2(US) = Điện cảm 2 (Mỹ)
Inductor2(EU) = Điện cảm 2 (châu Âu)
Battery = Pin
Voltage Source = Nguồn điện áp
Current Source = Hiện tại nguồn
CCCS(Current Controlled Current Source) = CCCS (hiện nay kiểm soát hiện tại nguồn)
CCCS2(Current Controlled Current Source) = CCCS (hiện nay kiểm soát hiện tại nguồn)
VCCS(Voltage Controlled Current Source) = VCCS (nguồn điện áp kiểm soát)
VCVS(Voltage Controlled Voltage Source) = VCVS (Điện áp điều khiển điện áp)
CCVS(Current Controlled Voltage Source) = CCVS (nguồn điện áp kiểm soát hiện tại)
CCVS2(Current Controlled Voltage Source) = CCVS2 (nguồn điện áp kiểm soát hiện tại)

BV(Behavioral Voltage Sources) = BV (Nguồn điện áp hành vi)
BI(Behavioral Voltage Sources) = BI (Nguồn điện áp hành vi)
Epoly(Non-linear Voltage Source) = Epoly (nguồn điện áp phi tuyến tính)
Gpoly(Non-linear Current Source) = Gpoly (nguồn không tuyến tính)

Diode = Diode
LED = LED
LED_3D =
Schottky Diode = Diode Schottky
Varactor Diode = Diode Varactor
Zener =
Unidirectional TVS Diode = Diode TVS vô hướng
Bidirectional TVS Diode = Di truyền TVS hai chiều
Diac = Diode kích hoạt hai chiều
Bridge = Cầu chỉnh lưu
78XX = 78XX
79XX = 79XX
LM317 = LM317
LM337 = LM337
TL431 = TL431
BJT(NPN) = Transistor (NPN)
BJT(PNP) = Transistor (PNP)
MOSFET(Nch) = MOSFET(Nch)
MOSFET(Nch) Depletion Four-pins = MOSFET(Nch) Depletion Four-pins
MOSFET(Nch) Enhancement = MOSFET(Nch) Enhancement
MOSFET(Nch) Enhancement Four-pins = MOSFET(Nch) Enhancement Four-pins
MOSFET(Pch) = MOSFET(Pch)
MOSFET(Pch) Depletion Four-pins = MOSFET(Pch) Depletion Four-pins
MOSFET(Pch) Enhancement = MOSFET(Pch) Enhancement
MOSFET(Pch) Enhancement Four-pins = MOSFET(Pch) Enhancement Four-pins
JFET(Nch) = JFET(Nch)
JFET(Pch) = JFET(Pch)
Darlington NPN = Darlington NPN
Darlington PNP = Darlington PNP
MESFET(Nch) = MESFET(Nch)
MESFET(Pch) = MESFET(Pch

IGBT = IGBT
SCR = SCR
Triac = Triac
Transform(US) = Transform(US)
Transform(EU) = Transform(EU
Transfrom(NEUTRAL-CTR TAP)(US) = Transfrom(NEUTRAL-CTR TAP)(US)
Transfrom(NEUTRAL-CTR TAP)(EU) = Transfrom(NEUTRAL-CTR TAP)(EU)
Mutual Inductors = Cuộn cảm tương hỗ
Mutual Inductors2 = Cuộn cảm tương hỗ 2
Or Gate = Or Gate
Xor Gate = Xor Gate
And Gate = And Gate
Nor Gate = Nor Gate
Nand Gate = Nand Gate
Not Gate = Not Gate
Xnor Gate = Xnor Gate
Tube Diode = Tube Diode
Tube Triode = Tube Triode
Tube Tetrode = Tube Tetrode
Tube Pentode = Tube Pentode
Voltage Controlled Switch = Điều khiển điện áp
Current Controlled Switch = Kiểm soát hiện tại Switch
SPST ON = SPST ON
SPST OFF = SPST OFF
Fuse = Cầu chì
555 = 555 giờ
555(Style2) = 555 giờ (Style2)
Speaker = Loa
XTAL = XTAL
5pin Operational Amplifier = 5-đầu cuối op amp
3pin Operational amplifier = 3-đầu cuối op amp
Transmission Line = Đường dây truyền tải
Voltmeter = Vôn kế
Ammeter = Ampe kế
LAMP = Bóng đèn
Opto Transistor = Phototransistor

#Server Message
Need login = Cần phải đăng nhập
Bad password = Mật khẩu sai
We can't find your username or your email, please check it! = Chúng tôi không thể tìm thấy tên người dùng hoặc email này, vui lòng kiểm tra lại
Make sure your uploaded file size is less than 3MB! = Vui lòng đảm bảo rằng kích thước tệp đã tải lên của bạn không được vượt quá 3MB!
Bad file type = Loại tệp sai
Empty file or bad file type, ensure your file is Eagle 6.0+ = Tệp trống hoặc loại tệp không hợp lệ, đảm bảo tệp của bạn là Eagle 6.0+
This operation not supported on demo account = Thao tác này không được hỗ trợ trên tài khoản demo
Can not share this file under a private project, please set the active project to public! = Không thể chia sẻ tài liệu cá nhân, hãy đặt dự án trước đó làm công khai
Login Failed Too many attempts. If you forgot your password, please {0}reset your password{1} or send an email to support@easyeda.com = Quá nhiều lỗi về mật khẩu, nếu bạn quên mật khẩu, hãy nhấp vào {0} Đặt lại mật khẩu {1}

#Dialog Common Buttons
Common Buttons Setting = Bộ nút
Menu Setting... =
Show/Hide = Hiển thị / ẩn
Move Up = Đi lên
Move Down = Đi xuống
Reset All = Đặt lại tất cả
Zoom = Phóng to
Place Pin = Đặt ghim

#System Setting Dialog
System = Thư viện hệ thống
Zoom Mode =
Scroll Key =
CTRL + Scroll =
Canvas Coordinate System =
SVG Coordinate =
Cartesian Coordinate =
Open Wizard Dialog for New Schematic =
Default Unit =
Canvas Zoom Effect =
Quality Priority =
Speed Priority =
Rotation Step =
Add Teardrop Automatically =
Assign Net for Free Track/Arc/Circle =
Open Wizard Dialog for New PCB =
Rebuild Plane Automatically =
The Track's Routing Follows Component's Rotation =
Display Pad's Number and Net =
Favorite Track width =
Track Width Setting =


#Dialog Access Control
Permissions = Quyền
Operation = Hoạt động
Access Control = Kiểm soát truy cập
Project Access Control = Kiểm soát truy cập dự án
Reject = Bị từ chối
Add User = Thêm người dùng
Bad email address = Địa chỉ email sai
# error info from backend
Can't find this email address in EasyEDA. Your partner must be an EasyEDA user. = Người dùng không tồn tại

#Dialog waveForm
Grid Background = Lưới nền
Pane Background = Nền nền
WaveForm Config = Cấu hình dạng sóng
Export Waveform = Dạng sóng xuất khẩu


#attr-canvas-grid-style
dot = dấu chấm
line = hàng

#attr-canvas-frame-size
Other = Khác
A4 Portrait = A4 dọc
A4 Landscape = A4 ngang
A3 Portrait = A3 dọc
A3 Landscape = A3 ngang
A2 Portrait = A2 dọc
A2 Landscape = A2 ngang
A1 Portrait = A1 dọc
A1 Landscape = A1 ngang
Landscape = ngang
Portrait = dọc

#Stroke Style
solid = chất rắn
dashed = đứt
dotted = say mê

#Solid Region
Solid Region = Vùng rắn
Type = Kiểu
type =

#Dialog Libs Management
Report error = Báo lỗi
Please give us some information to help us find the problem. = Vui lòng cho chúng tôi một gợi ý để tìm thông báo sai
Cannot place parts into this document: Schematic Symbols can only be placed into a Schematic; PCB Footprints can only be placed into a PCB. = Loại tài liệu không phù hợp, schematic thư viện chỉ có thể được đặt trên bản gốc, gói PCB chỉ có thể được đặt trên PCB
Save it as a favorite part = Lưu nó như một thiết bị yêu thích
Only logged-in users can save this component as a Favorite Part but guest (Anonymous) users can place this component into their design directly. Would you like to place this component now? = Chỉ những người dùng đã đăng nhập mới có thể lưu nó như một thiết bị yêu thích và khách truy cập được phép đặt thiết bị vào khung vải và bạn đã sẵn sàng để đặt nó ngay bây giờ

#Others
Find libs = Tìm thư viện
My Projects = Dự án của tôi
My Parts = Tập tin thư viện của tôi
My Modules = Mô-đun của tôi
Assembly LCSC Components = Li Chong các bộ phận SMD
Modules = Mô đun
SCH Module =
PCB Module = Mô đun PCB
System IC = Thư viện hệ thống
LCSC (Official) = Trung tâm mua sắm Li Chong
LCSC Electronics =
Simple Mode =
Expand Mode =
Help Verify =
Favorite Parts = Bộ sưu tập thiết bị
Shared With Me = Chia sẻ với tôi
Preview = Xem trước
Preview Window = Xem trước cửa sổ
System Default = Mặc định hệ thống
User Defined = Người dùng xác định
Theme = Chủ đề
Theme Setting = Cài đặt chủ đề
Close = Đóng
Open = Mở
Toggle toolbar = Mở / đóng thanh công cụ
Toggle left bar = Mở / đóng cột bên trái
Toggle right bar = Mở / đóng cột bên phải
Reload = Làm mới
Mouse-X = Con trỏ X
Mouse-Y = Con trỏ Y
Mouse-DX = Con trỏ DX
Mouse-DY = Con trỏ DY
Bus entry x1 = Nhập xe buýt x1
Bus entry x2 = Nhập xe buýt x2
Bus entry y1 = Nhập xe buýt y1
Bus entry y2 = Nhập xe buýt y2
Yes = Có
No = Không
OK = OK
Confirm =
Continue =
Cancel = Hủy
Update = Đã cập nhật
Bus entry = Đầu vào Bus
Filter = Bộ lọc
Check = Kiểm tra
Copy the contents of this box into a text editor, then save the file. Paste the edited text back into this box and click Apply to update the display. = Sao chép nội dung của hộp văn bản vào máy tính xách tay và lưu nó. Bạn có thể dán nội dung ở đây và chỉnh sửa lại.
Copy the contents of this box into a text editor, then save the file with a .svg extension. You can edit it in Inkscape or open it in your browser. = Sao chép nội dung của hộp văn bản vào máy tính xách tay và lưu nó bằng đuôi .svg. Bạn có thể chỉnh sửa nó bằng inkscape, hoặc bạn có thể mở nó bằng trình duyệt của bạn.
Content is too big to show, you can download it directly. =
SVG format = Định dạng SVG
SVG File = Tệp SVG
Description should be no more than 250 letters = Mô tả không thể vượt quá 250 ký tự
The file save operation has timed out. Try again and check your Internet connection. = Xuất tập tin mạng lưu hoạt động hết thời gian, phát hiện kết nối mạng và thử lại
Export Netlist = Xuất mạng
Notifications = Thông Báo
Please select txt or json files. = Vui lòng chọn tập tin txt hoặc json
Failed to read file [{file}]
[{file}] is not a valid json file
Invalid parameters! = Tham số không hợp lệ
Download = Tải về
Start = Bắt đầu
You have unsaved files, are you sure you want to log out without saving the files? = Có những tệp tin chưa được lưu, bỏ qua chúng và đăng xuất?
Please use the web version to run this function. = Vui lòng sử dụng chức năng này trong phiên bản web
Please save this file to you project! = Xin lưu tài liệu vào dự án
Nothing changed = Không thay đổi
Delete Node = Xóa giao lộ
This layer is invisible. = Lớp này là vô hình
When the solid region is Board Cutout, please set the layer to Multi-Layer. =
You should not try to assign a net to a Board Cutout solid region. =
Net Length = Chiều dài mạng
You can place a Pin in the schematic, but don't forget to group all of the Pins to a schematic component. Please click the help button to find out how to group them. If you just want to mark the wire, please use NetPort or NetLabel. =
Please input the modification =
The content must be between {0} and {1} characters =

Coming soon = Hãy theo dõi
No tool = Không có công cụ
Help us translate into your language = Giúp chúng tôi dịch
Pad = Tấm lót
Via/Hole = Thông qua lỗ
PCB Layers = Lớp PCB
Order PCB = Đặt hàng PCB
Share = Chia sẻ
Free = Miễn phí
Small = Nhỏ
Medium = Trong
Big = Lớn


Embed = Embed
HTML = HTML
URL = URL
BBCode = BBCode
PNG = PNG
Exporting as = Xuất khẩu dưới dạng
Exporting as image = Xuất dưới dạng ảnh
Exporting as {0}SVG{1} file. = Xuất dưới dạng tệp {0} SVG {1}
Exporting as pdf is recommended: pdf gives good quality printed output and a small file size. = Đề xuất xuất sang PDF, chất lượng in cao, kích thước tệp nhỏ.
Generate PCB Fabrication File(Gerber) = Tạo Gerber
PenWidth-Increase = Chiều rộng

#Generate Gerber
Generate Gerber =
Gerber View = Xem trước Gerber
Dimensions(Estimated) = Kích thước (ước tính)
PCB Qty = Số lượng PCB
Copper Weight = Độ dày đồng
PCB Price =
Estimated Delivery Time = Thời gian nhanh
HASL(with lead) = Chì
LeadFree HASL-RoHS = không chì
ENIG-RoHS = Mạ vàng
Would you like to do Design Rule Checking (DRC) before generating the Gerber files? =
Yes, Check DRC =
No, Generate Gerber =
This PCB has uncompleted connection(s), do you want to check the connection(s)? =
Yes, Check Connection(s) =
It will then redirect to the web site of a thirdparty JLCPCB with which we cooperate. Are you ready? =
Failed to submit your order, please contact us via support@easyeda.com for help. = Lệnh thất bại, vui lòng liên hệ với support@easyeda.com để được trợ giúp.
Failed to submit your order, please contact us via QQ 800821856. =
Order data generated finish, please click OK button and continue. =
[generateGerber]
Layers = Lớp
[/generateGerber]

[version]
Switch = Chuyển đổi
[/version]


Export your file, then print it yourself. = Xuất tập tin và in nó
Trace width is too small = Chiều rộng của dấu vết quá nhỏ
Share = Chia sẻ

Images Attribute = Thuộc tính hình ảnh
Connect Pad to Pad = Kết nối Pad Pad
Copper Area = Đồng
Dimension = Kích thước


Please check that you have used Wire and not Line to connect electrical elements. = Có thể bạn nên sử dụng dây nhưng không nhiều dây để kết nối các yếu tố điện.
PCB Fabrication Prices & capabilities = PCB chế tạo Giá cả và khả năng
Flip all texts on bottom layer = Lật tất cả văn bản trên lớp dưới cùng
Create New Document = Tài liệu mới
General Package = Gói thường dùng
General Packages = Gói thường dùng
favorite Package = Gói bộ sưu tập
Board Cutout =
Surface Mount = Nền bề mặt
JLCPCB Part Class =
base =
expand =
recommend =
Basic Part =
Extended Part =
Recommended Part =
smtWeld =
thtWeld =
manualWeld =
furnaceWeld =
Multi-Layer = Nhiều lớp
Markdown Syntax = Ngữ pháp Markdown
Markdown supported = Hỗ trợ Markdown
Read only = Chỉ đọc
Read/Write = Đọc viết
More Libraries... = Nhiều thành phần thư viện ...
Decompress failed! = Giải nén không thành công!
Load failed! = Không thể tải
Loading =
No Result = Không có kết quả

#Dialog Place Pin in schematic warning
Place Pin in schematic warning = Pin sắp xếp các biện pháp phòng ngừa trên schematic
You can place a Pin in schematic, but don't forget to group all of the Pins to a schematic component, please click the help button to find out how to group them. If you just want to mark the wire, please use NetPort or NetNabel. = Bạn có thể đặt mã Ghim trong giản đồ, nhưng đừng quên kết hợp các chân vào một thư viện giản đồ, nhấp vào nút trợ giúp để xem cách sử dụng. Nếu bạn chỉ gắn nhãn dây, sử dụng tab Mạng.
I know. Do not show this again. = Tôi biết, không nhắc lại tin nhắn.

#Extensions Setting
Extensions Setting = Cấu hình mở rộng
Remove = Hủy bỏ
Disable = Bị tắt
Enable = Đã bật
(Disabled) = (Bị vô hiệu)
(Enabled) = (Bật)
Load Extension = Tải phần mở rộng
Enable or disable will be applied after reload page = Bật hoặc tắt sẽ có hiệu lực sau khi trang được làm mới
Your browser cannot run this function. = Trình duyệt của bạn không thể chạy tính năng này.
Your browser mode does not support indexedDB. Some features may not work properly. Are you using Private Browsing Mode? =
Extension Files = ID mở rộng
Extension ID = ID mở rộng
Select Files = Chọn tệp

#Scripts
Script = Kịch bản
Scripts = Kịch bản
Script Content = Nội dung kịch bản
Load from js file = Nạp từ tệp JS
UTF-8 encoded js file = Tệp JS đã mã hoá UTF-8
Description = Mô tả
description = Mô tả
Not a *.js file = Không phải tệp * .js
Failed to read file = Không thể tải tệp
System scripts cannot be modified = Không thể sửa đổi tập lệnh hệ thống
Create Subfolder = Tạo một thư mục con
Create Script = Tạo một kịch bản
Install Script = Cài đặt kịch bản
Install = Cài đặt
Are you sure you want to remove this script? = Bạn có chắc chắn muốn xoá tập lệnh?
Folder Name = Tên thư mục
Rename = Đổi tên
Please select a script = Vui lòng chọn một kịch bản
Failed to load script = Không thể tải tập lệnh
Run Script = Chạy tập lệnh
Load Script = Tải tập lệnh
Title is required = Tiêu đề là bắt buộc
Script content is required = Nội dung kịch bản là bắt buộc
System Scripts = Kịch bản hệ thống
User Scripts = Tập lệnh người dùng
You can right click on the tree nodes. = Bạn có thể kích chuột phải vào nút cây.

#PCB photoView toolbar
Top Side = Đầu trang
Bottom Side = Đáy
With Silk Layer = Lớp màn tơ lụa
No Silk Layer = Không có lớp tơ lụa
Photo View = Xem trước ảnh

#check update
Check Update = Kiểm tra cập nhật
EasyEDA Editor {ver} is released. Would you like to switch to the new version now? = EasyEDA V {ver} đã được phát hành, bây giờ chuyển sang phiên bản mới?
LCEDA Editor {ver} is released. Would you like to switch to the new version now? =
Switch to New Version = Chuyển sang phiên bản mới
Next Time = Nói lại

#download project dialog
Generating download link... = Tạo liên kết tải xuống
Download project now = Nhấn vào đây để tải về dự án

#Import DXF
Import DXF = Nhập DXF
Apply Unit =
Convert circle to HOLE on BoardOutLine layer = Vòng tròn của lớp BoardOutLine được coi là một lỗ
No shapes found = Không có nội dung
Fail to load the file = Không thể tải tệp
Please select a DXF file. = Vui lòng chọn tệp DXF
This feature only works for PCB document. = Chức năng này chỉ có thể được sử dụng cho các tài liệu PCB
Select a DXF file = Chọn tệp DXF

#Export DXF
Export DXF =
Plated-Through-Hole Pads =
Non-Plated-Through-Hole Pads =
Silkscreen =
Surface Pad =

#Data Sync
Data Sync = Đồng bộ hóa dữ liệu
Data Conflicts = Xung đột dữ liệu
Project or Document = Dự án hoặc tài liệu
Cloud-Side = Cloud-Side
Local-Side = Địa phương kết thúc
Decision = Ra quyết định
Modified = Sửa đổi
Deleted = Bị xóa
As Cloud = Nhấn đám mây
As Local = Báo địa phương
Skip = Bỏ qua
Data sync completed = Đồng bộ hóa dữ liệu đã hoàn tất

#Team
Team = Đội
Teams = Đội
Switching team = Chuyển nhóm
Switch team failed = Nhóm chuyển đổi không thành công
Load team info fail! = Không đọc được thông tin về đội
Load team info fail! Please reload. = Không đọc được thông tin về nhóm, vui lòng làm mới thử lại
My Teams = Đội của tôi
Create Team = Đội mới

#Dialog Footprint Manager
Footprint Manager = Quản lý dấu chân
Open Footprint Manager =
Schematic Components = Thiết bị Schematic
Edit Pin Map Information = Chỉnh sửa Thông tin Bản đồ Pin
Package Categories = Danh mục gói hàng
Components List = Danh sách các thành phần
Personal = Thư viện cá nhân
Component PIN information = Thông tin về PIN thành phần
Footprint PAD information = Dấu chân thông tin PAD
Footprint Categories = Danh mục dấu chân
Pad Number = Số Pad
Search Footprint =
Filter by keyword = Lọc từ khoá
System Libs = Thư viện hệ thống

#dialog global delete
Drawings = Khác
Netlabel and netFlag = Thẻ mạng và định danh
Texts = Văn bản
Wires = Dây
Board outlines = Biên giới
Footprints = Trọn gói
Footprint =
Tracks = Dây

#dialog board outline settings
Current Size =
Paramenters =
Start X: =
Start Y: =
Round Rectangular =
radius =
only number is allowed! =
please input valid value of width! =
please input valid value of height! =
please input valid value of radius! =

#cross probe
The object you selected was not found in other documents. = Các tài liệu khác không tìm thấy các thành phần tương ứng
No valid object for cross probe selected. = Các thành phần có thể kiểm tra chéo không được chọn.
Can not probe. Refreshing the window may get it to work. = Kiểm tra chéo không thành công, làm mới thử
You need to login for this function to work. = Đăng nhập để sử dụng tính năng này.

#About Dialog
An Easier EDA Experience = Hiệu quả công cụ thiết kế điện tử trực tuyến
Version = Phiên bản
BuiltDate = Biên dịch ngày

#Auto Router Dialog
Auto Router Config = Cài đặt định tuyến tự động
General Options =
All Layers =
Configure =
Sorry, your web browser does not support this feature. Please run a modern browser. = Trình duyệt hiện tại không hỗ trợ chức năng này, vui lòng sử dụng trình duyệt hiện đại
Please make sure all objects with net are inside the board outline! =
Cannot start again before previous activity is stopped = Không thể bắt đầu lại trước khi dây cuối cùng
Please select a net = Vui lòng chọn mạng
TrackWidth cannot be empty =
Clearance cannot be empty =
Router is time out. = Thuê ngoài giờ
Server is busy, please try again later. = Máy chủ bận, vui lòng thử lại sau
Due to the limitation of {0}router server{1} resources, multiple routers executing concurrently are not supported, please try again later or do it manually :-) = Hạn chế bởi các tài nguyên máy chủ định tuyến tự động, trong khi hệ thống dây đa nhiệm không được hỗ trợ, vui lòng thử lại sau
Track Width is invalid = Chiều rộng dây không hợp lệ
General Clearance is invalid = Giải phóng mặt bằng chung không hợp lệ
SMD Clearance is invalid = Khoảng cách SMT không hợp lệ
Diameter is invalid = Đường kính không hợp lệ
Drill Diameter is invalid =
Track width cannot be less than Design Rule Checking (DRC) setting value. =
General Clearance cannot be less than Design Rule Checking (DRC) setting value. =
SMD Clearance cannot be less than Design Rule Checking (DRC) setting value. =
Hole size cannot be less than Design Rule Checking (DRC) setting value. =
Design Rule's via diameter must larger than via drill diameter =
Clearance cannot be less than Design Rule Checking (DRC) setting value. =
Not a valid PCB, please check it again = PCB không hợp lệ, vui lòng kiểm tra lại
Previous connection must be closed = Bạn phải đóng kết nối trước
Network error. Please try again. = Lỗi mạng, vui lòng thử lại sau
Router error. = Sai dây
Invalid PCB. = PCB không hợp lệ
General Clearance = Giải phóng mặt bằng chung
SMD Clearance = Khoảng cách SMD
#Ripup Nets
Skip Routed Nets = Bỏ qua mạng định tuyến
Remove Existing Tracks = Xoá dây điện hiện có
Real-time Display = Hiển thị thời gian thực
Router Layers = Lớp dây
Via = Thông qua lỗ
Special = Đặc biệt
Special Nets = Mạng đặc biệt
Skip Nets = Bỏ qua mạng
Router Server = Máy chủ cáp
Local = Địa phương
Cloud = Cloud
Available = Có sẵn
Unavailable = Không có sẵn
Checking = Thử nghiệm
Install Local Auto Router =
Checking local auto router server... = Dịch vụ cáp địa phương đang được thử nghiệm
Stop Router = Dừng dây
Auto Router is running... = Hoạt động dây tự động

#Left Siderbar
EELib = Thư viện cơ bản
Basic =
Extend =
Design Manager = Quản lý Thiết kế
Library =
Spice Library =
Shared = Chia sẻ
LCSC = Số LCSC
LCSC Parts =
Supply Flag = Bộ nhận dạng điện
US =
EU/IEC =
US Style = Phong cách Mỹ chuẩn
Resistor =
Capacitor =
Inductor =
Switch/Key =
EU/IEC Style = Phong cách châu Âu tiêu chuẩn
CN =
Connector = Kết nối
Switch/Relay = Chuyển mạch / chuyển tiếp
JLCPCB = Jia Li Chong
Recycle Bin =

# Protractor
Font Height = Chiều cao chữ
Precision = Độ chính xác
Protractor = Đo góc

#attr-pcbtext-line-width
Only default font family supports to change font width. =
Font is missing! You can confirm the dialog and use default font instead or cancel the dialog then upload your font and do it again. = Phông bị mất! Bạn có thể nhấp OK để sử dụng phông chữ mặc định hoặc Hủy, sau đó tải lên phông chữ.

#Common
Owner = Chủ sở hữu
License = Hợp đồng
Part Pins = Chân thành phần
Net Pins = Pin mạng
Net Ratlines =
Add Parameter =
Histories record = Lịch sử
Create Team = Đội mới
Can't find this footprint on the server, please re-associate it. =
The footprint name associated with the component and the footprint name on the server are inconsistent, please re-associate it. =
The symbol pin number(s) of the component does not match the associated footprint pad number(s), please modify the symbol pin number(s) or re-associate the footprint =
No footprint, please associate the footprint first. =
Can't find the package =
The path is for the project URL identify, it is unique (the identity of the project owned by the user cannot be the same) = Logo dự án cho hậu tố url dự án, biểu tượng độc đáo (người dùng có logo của dự án không thể giống nhau)
It's with a letter or a number and can contain only numbers, letters, line-through, underscores, and points. It cannot be modified after saving. = Biểu trưng bắt đầu bằng một chữ cái hoặc số, chỉ có thể chứa các con số, chữ cái, chữ thập, gạch dưới và không thể sửa đổi điểm sau khi lưu
Updating document to new format, please wait......After finishing please save your document with Ctrl + S. = Đang cập nhật tài liệu sang định dạng mới, vui lòng chờ ... Sau khi cập nhật hoàn tất, nhấn Ctrl + S để lưu tệp.
Open at current project? = Trong dự án hiện tại mở?
Please select a history to recover. = Vui lòng chọn khôi phục lịch sử.
Be careful! When you click the "Recover" button, this sheet will be overwritten! = Xin lưu ý! Nếu bạn nhấp vào nút "phục hồi", trang sẽ được bảo vệ!
Recover = Phục hồi
There is no PCB under this project, would you like to create one? = Không có PCB theo dự án, cho dù để tạo ra một?
Please make sure that the chose Altium Designer files are saved as ASCII files. = Vui lòng đảm bảo rằng các tệp tin được chọn của Altium Designer được lưu dưới dạng tệp ASCII.
Export to Altium function is currently in beta: =
1. Please be sure to read the notice before exporting: =
Export Altium notice and disclaimer =
2. Please be sure to check again after export! =
I have read and agree =
Export to Altium =
Please make sure that the chose Eagle files are saved in Eagle v6.0 and above. = Đảm bảo tệp Eagle bạn đã chọn là tệp lưu ở Eagle v6.0 trở lên.
Please make sure that the Kicad files were compressed as the .zip file. = Hãy chắc chắn rằng các tập tin Kicad được nén trong kho lưu trữ zip.
Open Altium Designer file = Mở tập tin thiết kế của Altium
The more information please refer at : =
Please use Gerber file instead of exporting Altium if you are going to do PCB manufacturing. All PCB factories support the Gerber file. Is it ok to Generate the Gerber file? =
Yes, Generate Gerber =
No, Export Altium =
Open Eagle file = Tệp mở Eagle
Open Kicad file = Mở tập tin Kicad
Select file(s) = Chọn tệp
Append to current project? = Chèn vào dự án hiện tại?
Append = Chèn
Open as new project = Mở cho dự án mới
Tip: Press {0}SPACE{1} or {2}R{3} to rotate the placing object or selected object. = Mẹo: Nhấn phím cách phím {0} spacebar {1} hoặc {2} R {3} để xoay phần được đặt hoặc chọn.
Hotkeys Setting = Cài đặt phím tắt
I know. Don't show this again. = Tôi biết, không còn hiển thị gợi ý này.
Manufacturer Part Number can not be less than 2 characters. =
This prefix was changed to non-subpart format. = Số đã được thay đổi thành định dạng không phải là thư viện con
Save as New Project = Lưu vào dự án mới
Save to Existing Project = Lưu vào dự án hiện tại
Sheet Setting = Cài đặt tài liệu
Sheet Size = Kích thước tài liệu
Pre = Số
pre = Số
Invalid Data = Định dạng dữ liệu sai
Others = Khác
You are not authorized to share this project. = Bạn không có quyền chia sẻ dự án
This project is private: if you continue sharing it will be made public. = Dự án là một dự án tư nhân, tiếp tục chia sẻ sẽ được mở.
Modify file info = Sửa đổi thông tin tài liệu
Please input search keyword = Vui lòng nhập từ khóa tìm kiếm
Sort Projects by = Sắp xếp theo
Date Created = Tạo thời gian
Date Modified = Sửa đổi thời gian
Title = Tiêu đề
Ascending = Thứ tự tăng dần
Descending = Thứ tự giảm dần
Pin to Top =
Unpin from Top =
Collapse / Expand =
Expand =
Collapse = Thu gọn
Expand All = Mở rộng tất cả
Collapse All = Thu gọn tất cả
Your file hasn't been saved, do you want to save it? = Tệp của bạn chưa được lưu, có lưu không?
Don't Save = Không lưu
Library Owner: = Chủ thư viện
verifyPkg.Value = Tên
State = Trạng thái
Please select! = Hãy chọn!
Route = Dây điện
Import successfully: = Nhập thành công
Import failed: = Nhập không thành công
The title length must be between 2~128 characters. =
Path only contain 'a-z、A-Z、- 、 _ 、0-9'! = Đường dẫn chỉ có thể chứa 'a-z, A-Z, -, _, 0-9'!
Path must begin as 'a-z、A-Z、0-9'! = Đường dẫn phải bắt đầu bằng 'a-z, A-Z, 0-9'!
The path length must be between 4~128 characters! = Độ dài đường dẫn từ 4 ~ 128 byte!
The title length must be between 2~256 characters! =
The title can not less than 3 charaters! =
Do you want to delete this file? = Bạn xác nhận rằng bạn cần phải xóa?
Add sub part success = Thêm thư viện phụ thành công
Please input name and prefix! = Vui lòng nhập số và tên
Board outlines are not closed = Đường biên của hội đồng quản trị không bị đóng
Import Altium file fail, the file needs to be an ASCII file encoded in UTF-8. =
The Pins "{0}" are not snapped on the grid point! This part maybe will cause some errors in the schematic. = Pin "{0}" không bị hấp phụ trên lưới điện! Thư viện này có thể tạo ra các lỗi trong sơ đồ mạch.
Check Pin =
Failed to read {0} = Không tải được {0}
{0} is invalid = {0} không có sẵn
{0} not found = {0} không tồn tại
Failed to execute script: = Không thể thực thi tập lệnh
One or more js files not found = Không tìm thấy một js
Only ONE {0} file is required = Chỉ {0} một tệp
Extension ID is required = ID mở rộng không thể để trống
Extension ID is invalid = ID tiện ích mở rộng không hợp lệ
Extension ID is duplicated = ID tiện ích mở rộng đã tồn tại
No Result! = Không có kết quả
Load Error = Không thể tải
loading = Đang nạp
Failed to load spice data = Không thể tải dữ liệu mô phỏng
Netlist =
Tags =
Pin Information: =
Format incorrect, please check for the extra spaces or commas! =
Round Radius =
Keyword: =
Image = Hình ảnh
Image copied. =
Copy failed. =
Image Attribute =
Locked =
Unlock All =
Unlock =
Lock =
Please input pin name and pin number! =
Left-Hand Panel =
Right-Hand Panel =
Update All =
The pin number(s) can't find the same pad number(s) =
Designator =
Replace =
Update failed =
Successfully updated =
Update failed! =
Successfully updated! =
Successfully updated {0} component(s)! =
Change =
Check  Footprints =
Network Error! =
Find Similar Objects =
Current Sheet =
All Sheets =
Kind =
Range =
Net Label/Net Flag/Net Port/Voltage Probe =
Bezier/Freehand Draw =
Arc/Pie =
Objects Attributes =
Any =
Same =
Different =
Circular =
Expose Copper =
"{0}" font is missing. Please add the font to the font family list. =
Place Component =
Delete Segment =
Angle =
Board Thickness =
Layer Distance =
Silk Screen =
Surface Finish Color =
Colors =
Board Color =
Board Side =
Silk Screen =
Silk Screen Color =
Display =

# Array and Clone
Distribute Array =
Array Type =
Matrix Array =
Circular Array =
Item Rotation =
Location =
Items per Column =
Items per Row =
# Column Spacing
# Row Spacing
Spacing(Degrees) =
Start Degree =
Rotate Item to Match =
Clockwise =
Anti-Clockwise =
Distribute by =
Column =
Row =
Array Clone =
Number of Rows =
Number of Columns =
Number of Copies =
Distribute Range(Degrees) =

# Theme color dialog
BusEntry =
Foreground = Màu mặt trước
Common Used = Thường được sử dụng
Original Theme =
Theme Setting = Cài đặt chủ đề
Change the theme colors of your design =
White on Black = Bản đồ màu trắng trên nền đen
Black on White = Bản đồ màu đen trên nền trắng
Custom Theme =
Color Setting =
Apply Setting =
Theme Setting... =
Bus Entry = Entry Bus
Foreground = Màu mặt trước
Symbol Graphics =
Common Used = Thường được sử dụng
Draw =
Sheet = Trang
The original theme only works for placing the new symbols. =
Selection Highlight =
Net Label / Port =

My Theme =
My Theme Settings =
Apply 'Custom Theme' On =
Creating New Schematic =
Opening Existed Schematic =
Please fill in all parameters! =
Convert to Board Cutout =
Prefix Position =
Name Position =
Center =
Top =
Bottom =
Left =
Right =
Does not support multiple objects to convert to Board Cutout at the same time =
Does not support multiple objects to convert to pad at the same time =
Convert to Board Cutout =
Convert to Pad =
Convert to Component Shape =
Combine to Continuous Track =
Convert to Solid Region =
Substrate =
3D View =
2D View =
Pin Color =
Name Color =
Number Color =
Dot =

[theme]
Sheet = Trang
[/theme]


#history dialog
[history-dlg]
Number = Số
Editor = Biên tập viên
[/history-dlg]
View File History = ịch sử
Save Time = Tiết kiệm thời gian

Invalid Format =

#Dialog Teardrop
Round Pad / Via =
Rectangle / Oval / Polygon Pad =
Applying Teardrops =
Removing Teardrops =
Waiting =
Progressing... =

No schematic in the project! =

Move Forward =
Move Backward =

#Dialog Panelize
V-CUT =
Stamp Hole =
No Panelize =
Border and Marking =
Create Border =
Border Height =
Border Position =
Create Positioning Holes =
Create Fiducial Marks =
Top and Bottom =
Left and Right =
Stamp Hole Group - Column =
Stamp Hole Group - Row =
The number of rows and columns cannot be set to 1 simultaneously =

#edit path point
[editPathPoints-dlg]
Arc(R) =
Type = Kiểu
Action =
add before =
add after =
delete =
[/editPathPoints-dlg]

#edit polygon point
[editPolygonPoints-dlg]
Action =
add before =
add after =
delete =
[/editPolygonPoints-dlg]
You have unconfirmed edit! =
Invalid edit! =

#Dialog PCB Information
PCB Information... = PCB Information...
Signal Layers = Signal Layers
None Signal Layers = None Signal Layers
Pads = Pads
Surface Pads = Surface Pads
Plated Through-hole Pads = Plated Through-hole Pads
None Plated Through-hole Pads = None Plated Through-hole Pads
Holes = Holes
Vias = Vias
Length of Tracks = Length of Tracks
Copper Areas = Copper Areas

#Differential Pair Routing
Differential Pair Routing =
Differential Pair Rule Setting =
Please input track width =
Please input clearance =
Routing Rules =

#Route Length Tuning
Track Length Tuning... =
Tracks with different net or non-track found in current targets. =
Please select the signal tracks to be tuning. =
The total length exceeds the Design Rule Checking (DRC) constraint, continue ? =
45° Angle =
90° Angle =
DRC Track Length : =
Current Length : =
Additional Length : =
Target Length: =
Current Length: =

can not connect to the server =

#Dialog Copper Area Manager
Copper Area Manager... =
Copper Area Manager =
Order =
Name = Tên
Layer = Lớp
Color = Màu
Net = Mạng lưới
Move Up = Đi lên
Move Down = Đi xuống
Apply = Ứng dụng
Cancel = Hủy
Copper Area do not allow self-intersection! =
No copper area! =
#Dialog report error
Datasheet = Datasheet
Verification = Verification
Symbol = Symbol
Pad Number = Số Pad
Pad Size =
Remark = Remark
Correct = Correct
Incorrect = Incorrect
Submit = Submit
Tip =
Please select one component =
Location X =
Location Y =
Your current browser version may not support some features. Please use the latest version of Chrome or Firefox, or try the desktop client. =
EasyEDA Client =
LCEDA Client =
Chrome =
FireFox =
New Version =
Switch Version =
Member =
Update Time =
Editor = Biên tập viên
Current Version: =
Select a version to switch =
3D Model =
Board Side =
Display =
Copper = Đồng
Create New Version =
Create new version success! =
Version Management =
Switch success! =
Please close current version's documents first! =
Creator =
Create Time =
Fail to connect to server! Please check your internet connection status and try again! =
Spice Number =
Create =
3D Outline =
Cannot create the slot hole via the board outline, please use the following methods: =
Use the solid region and set its type as Board Cutout =
Select a Track/Arc, right-click to use the "Convert to Board Cutout" =
Select all the closed Tracks/Arcs, right-click to use the "Convert to Board Cutout" =
The more information please refer at =
Save "{0}" success! =
Save "{0}" failed! =
Invalid Size =
Processing =
Invalid Size =
NetFlag GND = Bộ nhận diện GND
NetFlag VCC = Bộ nhận diện VCC
NetFlag +5v = Bộ nhận diện +5V
No Useful Data! =
SVG Preview =
Prefix contains not supported charater(s) ! =
Name contains not supported charater(s) ! =
Create Grid Path =
Please Input Name =
Building Copper Area =
Processing =
Opening File =
Update from Library =
Update Footprint =
Find footprint(s) have been updated, do you want to update? =
3D File: =
Model List =
Are you sure merge net {0} and net {1}? =
Display Footprint =
Display Footprint Name While Placing Component =
Annotate Prefix Automatically After Placing Component =
Program Error, Please Contact Technical Support! =
Search Engine =
Keyword to Filter =
Normal Mode =
Expand Mode =
3D Model Manager =
3D Model Preview =
3D Model =
3DModel =
Document = Tài liệu

[pcblayer]
3DModel =
Document = Tài liệu
[/pcblayer]

Adjustment =
View Larger Image =
Previous =
Previous Image =
Next Image =
Notice: For reference only, please refer to the real product =
It's under designing, please wait. =
The width of track/arc/circle can not less than 0.1mil! =
Clone success ! =
Footprint Naming Reference =
3D Model Manager =
Will jump to the Lichuang open source hardware platform (OSHWHub.com) to improve the information and share. Whether to continue? =
Will jump to the EasyEDA open source hardware platform (OSHWLab.com) to improve the information and share. Whether to continue? =
The project content page will open. After adding a description and setting the project to public, you can click the share button to get the share link. =
This project is not public, can not view homepage! =

[grid]
None = Không
[/grid]

#lib verify and mounted
This component is verified = 元件已经验证
This component is unmounted = 元件不上件

#find component
Find Next =
Object not found =

#offset Elements
Offset X =
Offset Y =
Offset =
Absolute Offset =
Relative Offset =
Absolute Offset... =
Relative Offset... =
Reference Point X =
Reference Point Y =

# Inner Plane layer
Rebuild Plane =
PlaneZone Properties =
Change to a plane layer is not allowed during track routing. =
#pcblib rect
Fill =
Fill Type =
[PlaneZone]
Solid = Đầy với chất rắn
[/PlaneZone]

Solid Region do not allow self-intersection! =

The prefix or name or text too far away from the footprint, if you don't want it to show up please make it hidden. =
The prefixes are not allowed to repeat! =
Save failed! The origin of the canvas is not in the graphics! Whether to set the origin automatically? =
The origin of the canvas has been set in the graphics now, you can save again. =
Backup Project =
Open Project Directory =

{0} items updated =

The current file {0} has an updated version. Do you want to overwrite it? If you want to open the latest version, please close the current file and reopen it. =
Yes, Overwrite It =
No, Keep It =

Download Client =

Search tutorial、open source projects etc. =

Go to LCSC and search for =
Go to LCSC =

Hide Ratline Layer and Keep the Component Prefix When Paste Objects =

ALL.layer =
Copper.layer =
Non-Copper.layer =
Other.layer =

Please enter at least 2 characters! =
View Datasheet =
View Datasheet... =

The corresponding package or network could not be found in the currently open PCB document =
delete fail =

[crashRecovery]
Libraries = Thư viện thành phần
[/crashRecovery]
Canvas origin anomaly! =

Component's Name =
Component's Prefix =
Component's Footprint =

[findlib]
Clear = Xóa
Apply Filters =
Result =
Place = Nơi
Prev =
Next =
Total {count} Count =
About = Trong khoảng
Items =
[/findlib]

Object =
Layers and Objects =
All = Tất cả

Add custom =

Connections =
Attempted: =
Completed: =
Failed: =
Total Vias: =

Please confirm moving option =
Only this pad =
For this component =
View Owner =
View Detail =


# place batch vias
Place Vias =
Placing Vias =
Removing Vias =
Batch Vias for Copper =
Add/Remove Vias =
Diameter = Đường kính
Drill Diameter =
Column Spacing =
Row Spacing =
Multiple vias have been placed, do you want to rebuild the copper area? =
Remove vias finish, do you want to rebuild the copper area? =
The width of track/arc/circle can not less than 0.051mm/2mil/0.002inch! =
Save fail! Please try again! =
Please select a copper outline =
Can't find copper area at other layers, please add the copper area with the same net at other layer first. =

Add favorite success! =
Remove favorite success! =
Remove favorite failed! =
Whether if remove favorite? =
Split by ';' for multi tags =

This size is the determined size! =
The associated pad has been locked =
Split by space or , for multi tags =

Rotation X =
Rotation Y =
Rotation Z =

Some fields are filled invalid data =
start time should be earlier than stop time =
Number of points should be less than 100 in octave variation =
Start frequency should be less than stop frequency. The suffix meg stands for Mega,m stands for milli =
Get historical records fail! =
This 3D model didn't create the outlines successfully, please import it again or contact with us. =
There is No Tag! =
Assign successful! =
Found footprint's pad number doesn't match the schematic component's pin number, please correct the pad number and try again! =
Update Attribute =
Please fill in at least 5 words. =
Mouse hovering over the track to highlight the entire network =
Net Highlighting While Cursor Hover the Track =
When circle set as "Yes", the Pin length must more than 6 =
Hi, I found a problem of your library, this library seems incorrect.\ntitle:{title}\nType:{type}\nlink:{link}\n{content}\nThank you! =

Logout fail! Please try again! =
Logout success! We look forward you to use LCEDA again! =
Logout success! We look forward you to use EasyEDA again! =
Click to Preview 3D =
[logoutDialog]
Logout = Đăng xuất
[/logoutDialog]

[findlibTag]
All = Tất cả
[/findlibTag]

Export Pick and Place File = Xuất tệp Tọa độ
Mirror the bottom component's X coordinate (JLCPCB doesn't need) =
Work Space =
Include panelized components' coordinates =
Personal Workspace =
Work Space - {name} =
Work Space - Personal =
Cloning =

Project Owner =
Clone Project =
Homepage =
Apply for Education Edition =
Load Organization failed =
Joined =
Favorite = Yêu thích
This operation will unfavorite this project, do you want to continue? =
View Homepage =
Private Project =
3-7 days =
Close Tab =
Close Other Tabs =
Close All Tabs =
Open in New Window =
Cursor Snap to Component's Origin or Pad Center While Dragging Component =
Undefined =
Input =
Model Unit =
File Unit =
This part contains subparts, please make sure you have checked other subparts before reporting error, do you want to continue? =

[saveAs]
Power =
[/saveAs]

Assign LCSC Part# =
Unexpected error while converting. Perhaps unsupported file type or program bug. =
Found duplicated component IDs, please click "OK" to re-assign component ID automatically, and then save the document and try again. =

#electromagneticSimulation
Electromagnetic Simulation... =
You will upload Gerber to SuperEM for electromagnetic simulation (only upload Gerber, not including account data), do you want to continue? =
SuperEM is a 3-D full-wave electromagnetic simulation and design platform for high-speed PCB circuits and antennas, which is developed by Faraday Dynamics, Ltd. =
Visit the SuperEM =
SuperEM User Guide =
Upload Gerber to SuperEM successfully, please click "OK" buttun to continue =

Format =
View = Lượt xem
Design =
Simulation = Mô phỏng
Advanced =
Fabrication =
Check DRC =
Simulation Setting =
BOM =
PCB Fabrication File(Gerber) =
Pick and Place File =
Parts Order =
PCB Order =
SIM =
STD =
WaveForm =

Place Module =
Please enter identification letters: =
Only support English letters, up to 5. =

Exist doesn't annotate prefix component(s) in the module, please edit and annotate the unique prefix(s) for component(s) first. =
Opening =

Also update track's net (Only applies to circumstance under which prefix/netlabel changes and no component/wire is added or removed) =

# desktop client error feedback
Cannot open online documents on Project Offline mode. =

Please select a project =
Opened Projects =
Open Project = Dự án nguồn mở
Close Project =
Open All Projects =
Close All Projects =
Select Owner =
Select Folder =
Select Owner or Folder =
Select Project =
Folder =
New Folder =
New Sub Folder =
Delete Folder =
Move Project =
Move Folder =
# Rename Folder =
Please input the folder name =
Invalid folder name =
Are you sure to delete this folder? =
Create new folder successfully =
Failed to create new folder =
Delete folder successfully =
Failed to delete folder =
Rename folder successfully =
Failed to rename folder =
Move folder successfully =
Failed to move folder =
Move project successfully =
Failed to move project =
The folder depth must not exceed {0} levels =
Failed to add project to folder =

Doesn't support JLCPCB SMT Service =
for JLCPCB SMT Service =

Reset failed! There are duplicate component prefixes in the current schematic: =
Reset failed! There are duplicate component prefixes in the current PCB: =
Please modify the component prefixes first to ensure that the component prefix is unique. =

LCEDA(Standard) - A Simple and Powerful Electronic Circuit Design Tool =
EasyEDA(Standard) - A Simple and Powerful Electronic Circuit Design Tool =

#Dialog for Package Custom Data
Please input the data title =
Data title duplicated =
Cannot be more than {0} characters! =
Only latin alphabets, digits, underscore(_) and hyphen(-) are allowed. =
Invalid value of item {0} =
Update DFM =
Custom DFM Data =
Saved custom data successfully! =
Save custom data failed! =
Will replace the graphics and custom data of current document, after imported please adjust the 3D model. Continue or not? =
Open footprint "Custom Data" dialog =

# Create lead shape
Create Lead Shape =
Base on Pad Center =
Base on Canvas Origin =
Lead shape =
Footprint Type =
From pad shape =
Lead length =
Lead width =
Lead diameter =
Scaling ratio =
Leads creating direction =
Auto = Tự động
Horizontal =
Vertical =
Canvas origin to lead edge =
Canvas origin to body edge =
Lead soldering length =
Lead soldering part diameter =
Component shape object doesn't overlap lead shape object, please check carefully. =
The solder mask expansion of pads ({0},{1}) has a small clearance(less then 0.08mm), it will cause the soldering too short, please modify. =
The paste mask expansion or custom paste mask layer objects of pads ({0},{1}) has a small clearance(less then 0.15mm), it will cause the stencil to create fail, please modify. =
System footprint must exist pad number 1 or A1, please modify the pad number. =
System footprint doesn't allow two or more pad numbers are 1 or A1, please modify the pad number. =
Document layer has circle object, but jlcPara's polarity is 0, please check the Custom Data. =
There are exist repeat pad numbers: {padNumber}, please check, if it is correct please ignore this. =
Can't find the circle at the component marking layer, or this circle doesn't at the same quadrant with the 1st pad, please check whether it is correct. =

ROUND =
RECTANGLE =
OCTAGONAL =
Upper left = Phía trái bên trên
Lower left = Phía trái bên dưới
Center of Pads = Trọng tâm miếng mạch
First Pin = Chân đầu tiên
Package Name = Tên kiểu linh kiện
Pins Number = Thứ tự chân
Rows Of Pin = Số hàng chân
Columns Of Pin = Số cột chân 
Polarity = Phân cực
Pad Shape = Hình dạng miếng mạch
Body Diameter = Đường kính thân
Lead Span = Độ mở tiếp điểm
Lead Vertical Span =
Body Length = Độ dài thân
Body Height = Chiều cao thân
Pin Diameter = Đường kính chân
Pin Length = Độ dài  chân
Pin Height = Chiều cao chân
Pin Solid Width = Độ rộng đặc của Chân linh kiện
Pin Solid Height = Chiều cao đặc của Chân linh kiện
Pin Spacing = Cách quãng chân linh kiện
Pin Horizontal Spacing = Cách quãng chân theo chiều ngang
Pin Vertical Spacing = Cách quãng chân theo chiều dọc
ThermalPad = Miếng tản nhiệt
Pad Expansion = Miếng mở rộng
Custom PasteMask = Điểm dán linh kiện tùy chọn
Fabrication Tolerance = Dung sai trong Chế tạo
Plcarment Tolerance = Dung sai Plcarment
FirstPin Position = Vị trí chân đầu tiên
Package Origin = Kiểu gốc
Expansion Size = Kích cỡ mở rộng
Corner = Góc
Angle = Góc chia độ
Fillet = 
Chamfer =
Update Preview = Cập nhập bản xem trước
Number of pins (left and right) = Số chân (trái và phải)
Number of pins (up and down) = Số chân (trên và dưới)
Reference Use Cases = Các trường hợp tham khảo
Package Type = Kiểu linh kiện
Capacitance = Dung kháng
Resistance = Trở khánh
Bidirectional Diode = Đi ốt hai chiều
Inductance = Cảm kháng
Crystal Oscillator = Bộ dao động
Diode = Diode
LED = LED
Fuse = Cầu chì
Entity height = Chiều cao bộ phận
Lead Overhang = Tiếp điểm treo
Lead Thickness = Độ dầy tiếp điểm
Unknown mistake = Lỗi không xác định
Has ThermalVias = Có lỗ truyền nhiệt
Polar Capacitance = Dung kháng phân cực

Create Component Marking =
Create component marking successfully! =
No elements on component shape layer! =
No elements on lead shape layer! =
No pad of number 1 or A1, please modify the pad number. =
Save failed! Component marking circle is at the axis. Do you want to recreate the component marking? =
If autoroute fail, you can export the autoroute file(DSN) to third-party autorouter tool(Such as: Konekt Electra, Eremex TopoR etc.), and export the session file(SES) after finished autoroute, and then import to PCB. =
Auto route failed! Found abnormal pad(s) data, please modify the pad width and height: = Tự động đi mạch không thành công! Phát hiện thấy dữ liệu các phần mạch (pad) bất thường, hãy chỉnh độ rộng phần mạch và độ cao:
Select Properties = Lựa chọn theo tính chất
Combine the same parts' prefixes in one row = Gộp các linh kiện có tiền tố giống nhau
Please check at least one item! = Hãy kiểm tra ít nhất một mục!
Pins = Chân
